id	title	group
alcoholismo	alcoholismo	tables/covid_cc_terms_symptom_v2.tsv
citocinas	citocinas	tables/covid_cc_terms_symptom_v2.tsv
choque séptico	choque séptico	tables/covid_cc_terms_symptom_v2.tsv
58 anos	58 anos	tables/covid_cc_terms_symptom_v2.tsv
21 anos	21 anos	tables/covid_cc_terms_symptom_v2.tsv
artromialgia generalizada	artromialgia generalizada	tables/covid_cc_terms_symptom_v2.tsv
mareos	mareos	tables/covid_cc_terms_symptom_v2.tsv
diabetes tipo 2	diabetes tipo 2	tables/covid_cc_terms_symptom_v2.tsv
29 anos	29 anos	tables/covid_cc_terms_symptom_v2.tsv
gestación	gestación	tables/covid_cc_terms_symptom_v2.tsv
4 de febrero	4 de febrero	tables/covid_cc_terms_symptom_v2.tsv
cardiomegalia (enfermedad)	cardiomegalia	ENFERMEDAD
cardiomegalia (sintoma)	cardiomegalia	SINTOMA
de coronavirus	de coronavirus	SINTOMA
prueba de ARN de sarscov2	prueba de ARN de sarscov2	SINTOMA
×2día	×2día	SINTOMA
síndrome coronario agudo	síndrome coronario agudo	SINTOMA
hiperlipidemia	hiperlipidemia	SINTOMA
bilirrubina	bilirrubina	SINTOMA
SNC	SNC	SINTOMA
enfermedad pulmonar obstructiva crónica	enfermedad pulmonar obstructiva crónica	SINTOMA
eructos	eructos	SINTOMA
15 de marzo	15 de marzo	SINTOMA
deterioro hemodinámico	deterioro hemodinámico	SINTOMA
prueba de sarscov2	prueba de sarscov2	SINTOMA
hipoxemia grave	hipoxemia grave	SINTOMA
corticosteroides sistémicos	corticosteroides sistémicos	SINTOMA
intervención coronaria percutánea	intervención coronaria percutánea	SINTOMA
tratamiento antivírico	tratamiento antivírico	SINTOMA
23 de mayo	23 de mayo	SINTOMA
disnea	disnea	SINTOMA
IgG	IgG	SINTOMA
IgA	IgA	SINTOMA
IgM	IgM	SINTOMA
extubación paliativa	extubación paliativa	SINTOMA
fumador (enfermedad)	fumador	ENFERMEDAD
fumador (sintoma)	fumador	SINTOMA
ipratropio	ipratropio	SINTOMA
china	china	SINTOMA
anemia grave	anemia grave	SINTOMA
intubado	intubado	SINTOMA
hipernatremia	hipernatremia	SINTOMA
colecistectomía	colecistectomía	SINTOMA
rickettsia	rickettsia	SINTOMA
exploración neurológica de las extremidades inferiores	exploración neurológica de las extremidades inferiores	SINTOMA
artralgia	artralgia	SINTOMA
atelectasia por compresión	atelectasia por compresión	SINTOMA
debilidad generalizada	debilidad generalizada	SINTOMA
dorsalgia en la zona dorsallumbar	dorsalgia en la zona dorsallumbar	SINTOMA
ritmo sinusal	ritmo sinusal	SINTOMA
gentamicina	gentamicina	SINTOMA
adenopatías mediastínicas	adenopatías mediastínicas	SINTOMA
exploración neurológica	exploración neurológica	SINTOMA
enfermedad cerebrovascular	enfermedad cerebrovascular	SINTOMA
colquicina	colquicina	SINTOMA
69 anos	69 anos	SINTOMA
síntomas respiratorios	síntomas respiratorios	SINTOMA
infección por 2019ncov	infección por 2019ncov	SINTOMA
covid19 (farmaco)	covid19	FARMACO
covid19 (enfermedad)	covid19	ENFERMEDAD
covid19 (id-sujeto-asistencia)	covid19	ID-SUJETO-ASISTENCIA
covid19 (sintoma)	covid19	SINTOMA
dilatación ventricular (enfermedad)	dilatación ventricular	ENFERMEDAD
dilatación ventricular (sintoma)	dilatación ventricular	SINTOMA
infecciones nosocomiales	infecciones nosocomiales	SINTOMA
gammaglobulina	gammaglobulina	SINTOMA
insuficiencia renal	insuficiencia renal	SINTOMA
síntomas abdominales	síntomas abdominales	SINTOMA
20 de enero	20 de enero	SINTOMA
protrombina	protrombina	SINTOMA
interferón α1b (farmaco)	interferón α1b	FARMACO
interferón α1b (proteinas)	interferón α1b	PROTEINAS
IgG de sarscov2	IgG de sarscov2	PROTEINAS
sdra	sdra	PROTEINAS
provincia de hubei	provincia de hubei	PROTEINAS
pseudomonas aeruginosa	pseudomonas aeruginosa	PROTEINAS
sulfato de magnesio	sulfato de magnesio	PROTEINAS
trombólisis	trombólisis	PROTEINAS
urocultivos	urocultivos	PROTEINAS
artralgias	artralgias	PROTEINAS
trombocitosis	trombocitosis	PROTEINAS
insuficiencia cardíaca aguda	insuficiencia cardíaca aguda	PROTEINAS
quetiapina	quetiapina	PROTEINAS
análisis del LCR	análisis del LCR	PROTEINAS
hipoxemia (enfermedad)	hipoxemia	ENFERMEDAD
hipoxemia (sintoma)	hipoxemia	SINTOMA
neumonía grave por covid19	neumonía grave por covid19	SINTOMA
oxigenoterapia	oxigenoterapia	SINTOMA
acidosis metabólica grave	acidosis metabólica grave	SINTOMA
neumonía atípica	neumonía atípica	SINTOMA
acidosis respiratoria	acidosis respiratoria	SINTOMA
A	A	SINTOMA
insuficiencia respiratoria grave	insuficiencia respiratoria grave	SINTOMA
lumbalgia	lumbalgia	SINTOMA
leche materna	leche materna	SINTOMA
escalofríos	escalofríos	SINTOMA
acidosis transitoria	acidosis transitoria	SINTOMA
disminución bilateral de los ruidos respiratorios	disminución bilateral de los ruidos respiratorios	SINTOMA
arreflexia generalizada	arreflexia generalizada	SINTOMA
electromiograma	electromiograma	SINTOMA
citomegalovirus	citomegalovirus	SINTOMA
angiografía	angiografía	SINTOMA
71 anos	71 anos	SINTOMA
proteina creactiva	proteina creactiva	SINTOMA
malestar torácico	malestar torácico	SINTOMA
frotis nasofaríngeos y orofaríngeos	frotis nasofaríngeos y orofaríngeos	SINTOMA
folato	folato	SINTOMA
anemia	anemia	SINTOMA
aspirados nasofaríngeos	aspirados nasofaríngeos	SINTOMA
ictus isquémico	ictus isquémico	SINTOMA
cotrimoxazol	cotrimoxazol	SINTOMA
neumotórax bilateral	neumotórax bilateral	SINTOMA
control antiinfecciosas	control antiinfecciosas	SINTOMA
acetaminofén	acetaminofén	SINTOMA
toxoplasma gondii (enfermedad)	toxoplasma gondii	ENFERMEDAD
toxoplasma gondii (species)	toxoplasma gondii	SPECIES
exploración	exploración	SPECIES
coronavirus	coronavirus	SPECIES
brudzinski	brudzinski	SPECIES
alteración de la marcha	alteración de la marcha	SPECIES
linfoadenopatía mediastínica	linfoadenopatía mediastínica	SPECIES
aumento del dímero D a 6120 ugl	aumento del dímero D a 6120 ugl	SPECIES
68 anos	68 anos	SPECIES
proteínas	proteínas	SPECIES
piperacilina	piperacilina	SPECIES
traqueostomía	traqueostomía	SPECIES
hiperintensidad	hiperintensidad	SPECIES
80 anos	80 anos	SPECIES
anticoagulante por vía oral	anticoagulante por vía oral	SPECIES
arritmia	arritmia	SPECIES
toxina de clostridium difficile	toxina de clostridium difficile	SPECIES
aumento de proteina creactiva	aumento de proteina creactiva	SPECIES
marzo de 2020	marzo de 2020	SPECIES
sarcoidosis alveolar	sarcoidosis alveolar	SPECIES
6 de marzo de 2020	6 de marzo de 2020	SPECIES
15 de abril	15 de abril	SPECIES
13 de febrero	13 de febrero	SPECIES
alteración de la conciencia	alteración de la conciencia	SPECIES
interferón beta 1a (farmaco)	interferón beta 1a	FARMACO
interferón beta 1a (proteinas)	interferón beta 1a	PROTEINAS
amiodarona	amiodarona	PROTEINAS
malestar general	malestar general	PROTEINAS
ECG	ECG	PROTEINAS
tos	tos	PROTEINAS
derrame pericárdico	derrame pericárdico	PROTEINAS
CMV	CMV	PROTEINAS
glucosa	glucosa	PROTEINAS
RMN	RMN	PROTEINAS
neumonía por sarscov2	neumonía por sarscov2	PROTEINAS
glucorraquia	glucorraquia	PROTEINAS
abril	abril	PROTEINAS
frotis nasal	frotis nasal	PROTEINAS
trombofilia	trombofilia	PROTEINAS
cloruro	cloruro	PROTEINAS
hemodiafiltración venovenosa continua	hemodiafiltración venovenosa continua	PROTEINAS
interferón beta 12	interferón beta 12	PROTEINAS
ceftriaxona	ceftriaxona	PROTEINAS
frotis orofaríngeo	frotis orofaríngeo	PROTEINAS
23 de marzo de 2020	23 de marzo de 2020	PROTEINAS
prueba de rtpcr	prueba de rtpcr	PROTEINAS
TAC torácica de la madre	TAC torácica de la madre	PROTEINAS
31 de enero	31 de enero	PROTEINAS
RMN vertebral	RMN vertebral	PROTEINAS
legionella pneumophila	legionella pneumophila	PROTEINAS
trastorno psicótico	trastorno psicótico	PROTEINAS
coagulopatía	coagulopatía	PROTEINAS
inmunoglobulinas	inmunoglobulinas	PROTEINAS
44 anos	44 anos	PROTEINAS
linezolid	linezolid	PROTEINAS
75 anos	75 anos	PROTEINAS
falleció (enfermedad)	falleció	ENFERMEDAD
falleció (sintoma)	falleció	SINTOMA
65 anos	65 anos	SINTOMA
TAC torácicas de la madre	TAC torácicas de la madre	SINTOMA
derrame pericárdico perimetral moderado	derrame pericárdico perimetral moderado	SINTOMA
inflamación linfocítica perivascular y perianexial	inflamación linfocítica perivascular y perianexial	SINTOMA
mycoplasma pneumoniae	mycoplasma pneumoniae	SINTOMA
carbono	carbono	SINTOMA
infección pulmonar	infección pulmonar	SINTOMA
troponinai	troponinai	SINTOMA
asma leve	asma leve	SINTOMA
ventilación mecánica	ventilación mecánica	SINTOMA
12 de enero	12 de enero	SINTOMA
sobreinfección por neumocistos	sobreinfección por neumocistos	SINTOMA
análisis de sangre	análisis de sangre	SINTOMA
cefalea	cefalea	SINTOMA
hbpm	hbpm	SINTOMA
hipotonía	hipotonía	SINTOMA
ictus	ictus	SINTOMA
azitromicina	azitromicina	SINTOMA
tos productiva	tos productiva	SINTOMA
procalcitonina	procalcitonina	SINTOMA
13 de noviembre de 2019	13 de noviembre de 2019	SINTOMA
edema miocárdico difuso	edema miocárdico difuso	SINTOMA
norepinefrina	norepinefrina	SINTOMA
sibilancias	sibilancias	SINTOMA
glucocorticoides	glucocorticoides	SINTOMA
sudoración intensa	sudoración intensa	SINTOMA
wuhan	wuhan	SINTOMA
diarrea (enfermedad)	diarrea	ENFERMEDAD
diarrea (sintoma)	diarrea	SINTOMA
aumento del esfuerzo respiratorio	aumento del esfuerzo respiratorio	SINTOMA
BCG	BCG	SINTOMA
opacidades de vidrio esmerilado en ambos pulmones	opacidades de vidrio esmerilado en ambos pulmones	SINTOMA
caballo	caballo	SINTOMA
anomalías de las extremidades superiores (enfermedad)	anomalías de las extremidades superiores	ENFERMEDAD
anomalías de las extremidades superiores (sintoma)	anomalías de las extremidades superiores	SINTOMA
aminotransferasa (farmaco)	aminotransferasa	FARMACO
aminotransferasa (proteinas)	aminotransferasa	PROTEINAS
neumonía bilateral grave	neumonía bilateral grave	PROTEINAS
hemocultivos	hemocultivos	PROTEINAS
C3	C3	PROTEINAS
PCR	PCR	PROTEINAS
C4	C4	PROTEINAS
10 de mayo	10 de mayo	PROTEINAS
virus de la gripe	virus de la gripe	PROTEINAS
CT (farmaco)	CT	FARMACO
CT (proteinas)	CT	PROTEINAS
opacidades pulmonares	opacidades pulmonares	PROTEINAS
debilidad facial	debilidad facial	PROTEINAS
roncus	roncus	PROTEINAS
difenhidramina	difenhidramina	PROTEINAS
bacilos	bacilos	PROTEINAS
lubeck	lubeck	PROTEINAS
TAC torácica sin contraste	TAC torácica sin contraste	PROTEINAS
Cr	Cr	PROTEINAS
dolor en su pierna	dolor en su pierna	PROTEINAS
cd4cd8	cd4cd8	PROTEINAS
aspergilosis	aspergilosis	PROTEINAS
malestar	malestar	PROTEINAS
análisis bioquímico sérico	análisis bioquímico sérico	PROTEINAS
tratada con corticoesteroides	tratada con corticoesteroides	PROTEINAS
acinetobacter	acinetobacter	PROTEINAS
hospital universitario de amiens	hospital universitario de amiens	PROTEINAS
ecografía doppler	ecografía doppler	PROTEINAS
insuficiencia cardiaca congestiva	insuficiencia cardiaca congestiva	PROTEINAS
antiinflamatorios no esteroideos (farmaco)	antiinflamatorios no esteroideos	FARMACO
antiinflamatorios no esteroideos (procedimiento)	antiinflamatorios no esteroideos	PROCEDIMIENTO
aspirado medular	aspirado medular	PROCEDIMIENTO
polipnea	polipnea	PROCEDIMIENTO
lavado broncoalveolar	lavado broncoalveolar	PROCEDIMIENTO
consolidación parenquimatosa	consolidación parenquimatosa	PROCEDIMIENTO
PCT	PCT	PROCEDIMIENTO
benralizumab	benralizumab	PROCEDIMIENTO
prueba rtpcr	prueba rtpcr	PROCEDIMIENTO
intubación endotraqueal	intubación endotraqueal	PROCEDIMIENTO
PCR del LCR para detección de sarscov2 fue negativa	PCR del LCR para detección de sarscov2 fue negativa	PROCEDIMIENTO
tratamiento con integrilin	tratamiento con integrilin	PROCEDIMIENTO
lactatodeshidrogenasa	lactatodeshidrogenasa	PROCEDIMIENTO
disminución de la ingesta oral	disminución de la ingesta oral	PROCEDIMIENTO
radiografía torácica anteroposterior	radiografía torácica anteroposterior	PROCEDIMIENTO
rehabilitación	rehabilitación	PROCEDIMIENTO
cultivos víricos en células vero	cultivos víricos en células vero	PROCEDIMIENTO
piperacilina–tazobactam	piperacilina–tazobactam	PROCEDIMIENTO
mayo	mayo	PROCEDIMIENTO
evaluación de las extremidades inferiores	evaluación de las extremidades inferiores	PROCEDIMIENTO
frotis	frotis	PROCEDIMIENTO
rtpcr de frotis nasofaríngeo	rtpcr de frotis nasofaríngeo	PROCEDIMIENTO
RMN cerebral y de los huesos temporales	RMN cerebral y de los huesos temporales	PROCEDIMIENTO
prueba molecular de sarscov2	prueba molecular de sarscov2	PROCEDIMIENTO
miopericarditis aguda	miopericarditis aguda	PROCEDIMIENTO
prueba de troponina I	prueba de troponina I	PROCEDIMIENTO
apendicitis aguda	apendicitis aguda	PROCEDIMIENTO
27 de abril	27 de abril	PROCEDIMIENTO
japon	japon	PROCEDIMIENTO
7 de marzo	7 de marzo	PROCEDIMIENTO
síntomas paragripales	síntomas paragripales	PROCEDIMIENTO
deshidratación moderada	deshidratación moderada	PROCEDIMIENTO
26 anos	26 anos	PROCEDIMIENTO
exantema	exantema	PROCEDIMIENTO
artritis reumatoide	artritis reumatoide	PROCEDIMIENTO
covid19 subclínica	covid19 subclínica	PROCEDIMIENTO
acetaminofeno	acetaminofeno	PROCEDIMIENTO
retiraron los antibióticos	retiraron los antibióticos	PROCEDIMIENTO
diarreas	diarreas	PROCEDIMIENTO
enfermedad mieloproliferativa	enfermedad mieloproliferativa	PROCEDIMIENTO
anestesia	anestesia	PROCEDIMIENTO
estados unidos	estados unidos	PROCEDIMIENTO
salina isotónica	salina isotónica	PROCEDIMIENTO
12 de marzo de 2020	12 de marzo de 2020	PROCEDIMIENTO
erupción de placas eritematosas pruriginosas	erupción de placas eritematosas pruriginosas	PROCEDIMIENTO
urticaria (enfermedad)	urticaria	ENFERMEDAD
urticaria (sintoma)	urticaria	SINTOMA
encefalopatía	encefalopatía	SINTOMA
hemiplegia faciobraquiofemoral	hemiplegia faciobraquiofemoral	SINTOMA
choque	choque	SINTOMA
hiperleucocitosis	hiperleucocitosis	SINTOMA
diálisis local de utah	diálisis local de utah	SINTOMA
dolor torácico	dolor torácico	SINTOMA
albúmina301	albúmina301	SINTOMA
mialgias	mialgias	SINTOMA
ADA	ADA	SINTOMA
ensayo inmunocromatográfico	ensayo inmunocromatográfico	SINTOMA
dímero D (farmaco)	dímero D	FARMACO
dímero D (proteinas)	dímero D	PROTEINAS
enoxaparina	enoxaparina	PROTEINAS
congestión	congestión	PROTEINAS
abrasiones en los labios y mucosa bucal	abrasiones en los labios y mucosa bucal	PROTEINAS
estado epiléptico	estado epiléptico	PROTEINAS
prohormona	prohormona	PROTEINAS
metilprednisolona	metilprednisolona	PROTEINAS
sitagliptina	sitagliptina	PROTEINAS
sarscov2 (farmaco)	sarscov2	FARMACO
sarscov2 (enfermedad)	sarscov2	ENFERMEDAD
sarscov2 (procedimiento)	sarscov2	PROCEDIMIENTO
corticoides (farmaco)	corticoides	FARMACO
corticoides (procedimiento)	corticoides	PROCEDIMIENTO
creatinina	creatinina	PROCEDIMIENTO
alucinaciones	alucinaciones	PROCEDIMIENTO
recién nacido	recién nacido	PROCEDIMIENTO
creatinacinasa	creatinacinasa	PROCEDIMIENTO
aumento de la lactatodeshidrogenasa	aumento de la lactatodeshidrogenasa	PROCEDIMIENTO
ecografía a pie de cama	ecografía a pie de cama	PROCEDIMIENTO
lesiones cutáneas	lesiones cutáneas	PROCEDIMIENTO
oxigenoterapia mediante cánula nasal	oxigenoterapia mediante cánula nasal	PROCEDIMIENTO
cincuenta anos	cincuenta anos	PROCEDIMIENTO
biopsia	biopsia	PROCEDIMIENTO
aumento de la cifra de trombocitos	aumento de la cifra de trombocitos	PROCEDIMIENTO
meticilina	meticilina	PROCEDIMIENTO
claritromicina	claritromicina	PROCEDIMIENTO
radioterapia	radioterapia	PROCEDIMIENTO
aptc	aptc	PROCEDIMIENTO
herpes zóster	herpes zóster	PROCEDIMIENTO
odinofagia	odinofagia	PROCEDIMIENTO
losartán	losartán	PROCEDIMIENTO
heparina de bajo peso molecular	heparina de bajo peso molecular	PROCEDIMIENTO
parvovirus B19	parvovirus B19	PROCEDIMIENTO
63 anos	63 anos	PROCEDIMIENTO
ácido fólico	ácido fólico	PROCEDIMIENTO
dermatosis neutrofílica	dermatosis neutrofílica	PROCEDIMIENTO
aumento significativo de proteína creactiva	aumento significativo de proteína creactiva	PROCEDIMIENTO
Hb	Hb	PROCEDIMIENTO
sdra grave	sdra grave	PROCEDIMIENTO
ribavirina	ribavirina	PROCEDIMIENTO
síncope	síncope	PROCEDIMIENTO
bacterias	bacterias	PROCEDIMIENTO
derrame pleural bilateral	derrame pleural bilateral	PROCEDIMIENTO
laparotomía	laparotomía	PROCEDIMIENTO
TAC torácicas	TAC torácicas	PROCEDIMIENTO
enfisema	enfisema	PROCEDIMIENTO
enfermedad por coronavirus 2019	enfermedad por coronavirus 2019	PROCEDIMIENTO
neumonía grave	neumonía grave	PROCEDIMIENTO
congestión nasal	congestión nasal	PROCEDIMIENTO
exploración pulmonar	exploración pulmonar	PROCEDIMIENTO
pulsioximetría	pulsioximetría	PROCEDIMIENTO
esputo parduzco	esputo parduzco	PROCEDIMIENTO
lesiones miocárdicas	lesiones miocárdicas	PROCEDIMIENTO
análisis histológico placentario	análisis histológico placentario	PROCEDIMIENTO
26 de marzo de 2020	26 de marzo de 2020	PROCEDIMIENTO
tos seca	tos seca	PROCEDIMIENTO
infección por covid19	infección por covid19	PROCEDIMIENTO
24 de febrero	24 de febrero	PROCEDIMIENTO
administraron antibióticos y antipiréticos	administraron antibióticos y antipiréticos	PROCEDIMIENTO
virus de la hepatitis C	virus de la hepatitis C	PROCEDIMIENTO
meronepem	meronepem	PROCEDIMIENTO
crisis	crisis	PROCEDIMIENTO
ecografías torácicas	ecografías torácicas	PROCEDIMIENTO
insuficiencia respiratoria hipoxémica aguda	insuficiencia respiratoria hipoxémica aguda	PROCEDIMIENTO
artropatía degenerativa cervical	artropatía degenerativa cervical	PROCEDIMIENTO
alaninaaminotransferasa	alaninaaminotransferasa	PROCEDIMIENTO
20 de febrero	20 de febrero	PROCEDIMIENTO
neumonía intersticial grave	neumonía intersticial grave	PROCEDIMIENTO
trombosis venosa profunda	trombosis venosa profunda	PROCEDIMIENTO
levotiroxina	levotiroxina	PROCEDIMIENTO
atelectasia subsegmentaria	atelectasia subsegmentaria	PROCEDIMIENTO
26 de marzo	26 de marzo	PROCEDIMIENTO
hemoglobina	hemoglobina	PROCEDIMIENTO
doxiciclina	doxiciclina	PROCEDIMIENTO
metoprolol	metoprolol	PROCEDIMIENTO
escocia	escocia	PROCEDIMIENTO
taquipnea	taquipnea	PROCEDIMIENTO
diarrea intermitente	diarrea intermitente	PROCEDIMIENTO
auscultación pulmonar posterior	auscultación pulmonar posterior	PROCEDIMIENTO
ERC	ERC	PROCEDIMIENTO
varon	varon	PROCEDIMIENTO
asma	asma	PROCEDIMIENTO
29 de febrero	29 de febrero	PROCEDIMIENTO
hipotiroidismo	hipotiroidismo	PROCEDIMIENTO
emtricitabine	emtricitabine	PROCEDIMIENTO
hiponatremia	hiponatremia	PROCEDIMIENTO
insuficiencia multiorgánica	insuficiencia multiorgánica	PROCEDIMIENTO
atorvastatina	atorvastatina	PROCEDIMIENTO
hombre (sexo-sujeto-asistencia)	hombre	SEXO-SUJETO-ASISTENCIA
hombre (species)	hombre	SPECIES
interferón α (farmaco)	interferón α	FARMACO
interferón α (proteinas)	interferón α	PROTEINAS
punción lumbar	punción lumbar	PROTEINAS
cardiopatía coronaria	cardiopatía coronaria	PROTEINAS
lloro excesivo	lloro excesivo	PROTEINAS
síndrome inflamatorio	síndrome inflamatorio	PROTEINAS
tacrólimus	tacrólimus	PROTEINAS
paracetamol	paracetamol	PROTEINAS
midazolam	midazolam	PROTEINAS
6 de febrero	6 de febrero	PROTEINAS
exploración histológica	exploración histológica	PROTEINAS
bronquiolitis adenovírica	bronquiolitis adenovírica	PROTEINAS
insomnio (enfermedad)	insomnio	ENFERMEDAD
insomnio (sintoma)	insomnio	SINTOMA
marzo	marzo	SINTOMA
11 de febrero	11 de febrero	SINTOMA
17 de marzo	17 de marzo	SINTOMA
adrenalina	adrenalina	SINTOMA
12 de covid	12 de covid	SINTOMA
prohormona nterminal del péptido	prohormona nterminal del péptido	SINTOMA
TVP bilateral	TVP bilateral	SINTOMA
hipertensión arterial	hipertensión arterial	SINTOMA
arteriopatía coronaria	arteriopatía coronaria	SINTOMA
hipertensión arterial sistémica	hipertensión arterial sistémica	SINTOMA
furosemida	furosemida	SINTOMA
gasometría	gasometría	SINTOMA
oxigenoterapia con cánula nasal	oxigenoterapia con cánula nasal	SINTOMA
25 de marzo	25 de marzo	SINTOMA
klebsiella pneumoniae	klebsiella pneumoniae	SINTOMA
metformina	metformina	SINTOMA
anorexia	anorexia	SINTOMA
ENA	ENA	SINTOMA
bicarbonato	bicarbonato	SINTOMA
loratadina	loratadina	SINTOMA
brasil	brasil	SINTOMA
adelgazamiento	adelgazamiento	SINTOMA
sensación distérmica	sensación distérmica	SINTOMA
frotis nasales	frotis nasales	SINTOMA
buen estado general	buen estado general	SINTOMA
plasmaféresis	plasmaféresis	SINTOMA
congestión conjuntival	congestión conjuntival	SINTOMA
hemorragia alveolar difusa	hemorragia alveolar difusa	SINTOMA
alteración del estado mental	alteración del estado mental	SINTOMA
síntomas respiratorios leves	síntomas respiratorios leves	SINTOMA
neurológica	neurológica	SINTOMA
insuficiencia renal crónica	insuficiencia renal crónica	SINTOMA
radiografía torácica	radiografía torácica	SINTOMA
fisioterapia	fisioterapia	SINTOMA
anticuerpos citoplasmáticos antineutrofílicos	anticuerpos citoplasmáticos antineutrofílicos	SINTOMA
miocarditis aguda	miocarditis aguda	SINTOMA
TAC abdominal	TAC abdominal	SINTOMA
insulina (farmaco)	insulina	FARMACO
insulina (proteinas)	insulina	PROTEINAS
sulfametoxazol	sulfametoxazol	PROTEINAS
ritonavir	ritonavir	PROTEINAS
hiperfibrinogenemia	hiperfibrinogenemia	PROTEINAS
ambroxol	ambroxol	PROTEINAS
suero	suero	PROTEINAS
sulbactam	sulbactam	PROTEINAS
25 de marzo de 2020	25 de marzo de 2020	PROTEINAS
rivaroxaban	rivaroxaban	PROTEINAS
exploración respiratoria	exploración respiratoria	PROTEINAS
hidroxicloroquina (farmaco)	hidroxicloroquina	FARMACO
hidroxicloroquina (proteinas)	hidroxicloroquina	PROTEINAS
vitaminas	vitaminas	PROTEINAS
coronavirus nl63	coronavirus nl63	PROTEINAS
hco3	hco3	PROTEINAS
acumulación de líquido libre en la zona paracólica derecha y pélvica	acumulación de líquido libre en la zona paracólica derecha y pélvica	PROTEINAS
radiografías torácicas	radiografías torácicas	PROTEINAS
dolor de garganta	dolor de garganta	PROTEINAS
M tuberculosis	M tuberculosis	PROTEINAS
cefalea frontal	cefalea frontal	PROTEINAS
antibióticos betalactámicos intravenosos	antibióticos betalactámicos intravenosos	PROTEINAS
infección	infección	PROTEINAS
debilidad	debilidad	PROTEINAS
neuropatía aguda sensitivomotora axónica	neuropatía aguda sensitivomotora axónica	PROTEINAS
dolor	dolor	PROTEINAS
tratamiento antiinflamatorio	tratamiento antiinflamatorio	PROTEINAS
infecciones	infecciones	PROTEINAS
síndrome meníngeo	síndrome meníngeo	PROTEINAS
linfoadenopatía cervical	linfoadenopatía cervical	PROTEINAS
reanimación cardiopulmonar	reanimación cardiopulmonar	PROTEINAS
P jirovecii	P jirovecii	PROTEINAS
aine (farmaco)	aine	FARMACO
aine (procedimiento)	aine	PROCEDIMIENTO
neumonía bilateral	neumonía bilateral	PROCEDIMIENTO
mialgia (farmaco)	mialgia	FARMACO
mialgia (proteinas)	mialgia	PROTEINAS
mialgia (sintoma)	mialgia	SINTOMA
disfunción respiratoria (enfermedad)	disfunción respiratoria	ENFERMEDAD
disfunción respiratoria (sintoma)	disfunción respiratoria	SINTOMA
acidosis láctica	acidosis láctica	SINTOMA
HAA	HAA	SINTOMA
BNP	BNP	SINTOMA
clavulanato	clavulanato	SINTOMA
lesiones pulmonares	lesiones pulmonares	SINTOMA
hangzhou	hangzhou	SINTOMA
lopinavir	lopinavir	SINTOMA
EMG	EMG	SINTOMA
virus de la inmunodeficiencia humana	virus de la inmunodeficiencia humana	SINTOMA
ventilación mecánica no invasiva	ventilación mecánica no invasiva	SINTOMA
consolidación mixta segmentaria	consolidación mixta segmentaria	SINTOMA
asma eosinofílica grave	asma eosinofílica grave	SINTOMA
LDH	LDH	SINTOMA
delirio extravagante	delirio extravagante	SINTOMA
taquicardia (enfermedad)	taquicardia	ENFERMEDAD
taquicardia (sintoma)	taquicardia	SINTOMA
frotis nasofaríngeo	frotis nasofaríngeo	SINTOMA
cloroquina	cloroquina	SINTOMA
debilidad muscular	debilidad muscular	SINTOMA
administró hidratación	administró hidratación	SINTOMA
parestesia	parestesia	SINTOMA
venlafaxina	venlafaxina	SINTOMA
estudios de conducción nerviosa	estudios de conducción nerviosa	SINTOMA
vasoactivos	vasoactivos	SINTOMA
anosmia (enfermedad)	anosmia	ENFERMEDAD
anosmia (sintoma)	anosmia	SINTOMA
imipenem	imipenem	SINTOMA
prueba de gripe	prueba de gripe	SINTOMA
gasometría arterial	gasometría arterial	SINTOMA
malestar agudo	malestar agudo	SINTOMA
anticoagulante (farmaco)	anticoagulante	FARMACO
anticoagulante (procedimiento)	anticoagulante	PROCEDIMIENTO
PCR de sarscov2	PCR de sarscov2	PROCEDIMIENTO
abrasión del labio inferior (enfermedad)	abrasión del labio inferior	ENFERMEDAD
abrasión del labio inferior (sintoma)	abrasión del labio inferior	SINTOMA
buen estado de salud general	buen estado de salud general	SINTOMA
manitol	manitol	SINTOMA
radiografía de tórax	radiografía de tórax	SINTOMA
oxígeno (farmaco)	oxígeno	FARMACO
oxígeno (procedimiento)	oxígeno	PROCEDIMIENTO
12 de marzo	12 de marzo	PROCEDIMIENTO
IL6	IL6	PROCEDIMIENTO
dislipidemia	dislipidemia	PROCEDIMIENTO
varicela zóster	varicela zóster	PROCEDIMIENTO
frotis nasofaríngeos	frotis nasofaríngeos	PROCEDIMIENTO
angiografía por TAC	angiografía por TAC	PROCEDIMIENTO
terapia antivírica	terapia antivírica	PROCEDIMIENTO
antibióticos	antibióticos	PROCEDIMIENTO
virus de la gripe B	virus de la gripe B	PROCEDIMIENTO
virus de la gripe A	virus de la gripe A	PROCEDIMIENTO
artromialgia	artromialgia	PROCEDIMIENTO
infliximab (farmaco)	infliximab	FARMACO
infliximab (proteinas)	infliximab	PROTEINAS
enfermedades cardiovasculares	enfermedades cardiovasculares	PROTEINAS
apirexia	apirexia	PROTEINAS
irritación de garganta	irritación de garganta	PROTEINAS
28 de febrero de 2020	28 de febrero de 2020	PROTEINAS
14 de febrero	14 de febrero	PROTEINAS
de tormenta de citocinas	de tormenta de citocinas	PROTEINAS
29 de marzo	29 de marzo	PROTEINAS
fasciotomías en ambos brazos y ambas piernas	fasciotomías en ambos brazos y ambas piernas	PROTEINAS
PCR de sangre y LCR	PCR de sangre y LCR	PROTEINAS
complemento	complemento	PROTEINAS
anamnesis	anamnesis	PROTEINAS
ecocardiograma	ecocardiograma	PROTEINAS
aspirado traqueal	aspirado traqueal	PROTEINAS
afasia anómica (enfermedad)	afasia anómica	ENFERMEDAD
afasia anómica (sintoma)	afasia anómica	SINTOMA
embarazos	embarazos	SINTOMA
9 de marzo	9 de marzo	SINTOMA
astenia	astenia	SINTOMA
enero	enero	SINTOMA
deterioro de la actividad renal	deterioro de la actividad renal	SINTOMA
32 anos	32 anos	SINTOMA
21 de abril	21 de abril	SINTOMA
edema pulmonar (enfermedad)	edema pulmonar	ENFERMEDAD
edema pulmonar (sintoma)	edema pulmonar	SINTOMA
madrid	madrid	SINTOMA
anemia normocítica	anemia normocítica	SINTOMA
favipiravir	favipiravir	SINTOMA
arbidol	arbidol	SINTOMA
expectoración	expectoración	SINTOMA
insuficiencia cardiaca	insuficiencia cardiaca	SINTOMA
francia	francia	SINTOMA
aumento de tamaño	aumento de tamaño	SINTOMA
31 de marzo	31 de marzo	SINTOMA
15 de marzo de 2020	15 de marzo de 2020	SINTOMA
Na	Na	SINTOMA
levofloxacina	levofloxacina	SINTOMA
dolor torácico pleural	dolor torácico pleural	SINTOMA
hemofagocitosis	hemofagocitosis	SINTOMA
hipotensión (enfermedad)	hipotensión	ENFERMEDAD
hipotensión (sintoma)	hipotensión	SINTOMA
ciudad de wuhan	ciudad de wuhan	SINTOMA
derrame pleural	derrame pleural	SINTOMA
italia	italia	SINTOMA
20 de marzo	20 de marzo	SINTOMA
TAC craneal	TAC craneal	SINTOMA
reducción de la ingesta oral	reducción de la ingesta oral	SINTOMA
linfocitopenia (farmaco)	linfocitopenia	FARMACO
linfocitopenia (enfermedad)	linfocitopenia	ENFERMEDAD
linfocitopenia (proteinas)	linfocitopenia	PROTEINAS
linfocitopenia (sintoma)	linfocitopenia	SINTOMA
electrocardiograma	electrocardiograma	SINTOMA
elevación cóncava del ST y descenso del PR	elevación cóncava del ST y descenso del PR	SINTOMA
aspiración de cánula orotraqueal	aspiración de cánula orotraqueal	SINTOMA
panel de patógenos respiratorios	panel de patógenos respiratorios	SINTOMA
streptococcus pneumoniae	streptococcus pneumoniae	SINTOMA
darunavir	darunavir	SINTOMA
disfunción del ventrículo	disfunción del ventrículo	SINTOMA
ablación cardiaca triple	ablación cardiaca triple	SINTOMA
alteración mental	alteración mental	SINTOMA
pruebas analíticas del LCR	pruebas analíticas del LCR	SINTOMA
neumonía intersticial	neumonía intersticial	SINTOMA
hidroclorotiazida	hidroclorotiazida	SINTOMA
oseltamivir	oseltamivir	SINTOMA
SGB	SGB	SINTOMA
taponamiento del circuito de diálisis	taponamiento del circuito de diálisis	SINTOMA
IET	IET	SINTOMA
dolor en las extremidades inferiores	dolor en las extremidades inferiores	SINTOMA
insuficiencia respiratoria	insuficiencia respiratoria	SINTOMA
fármacos inmunosupresores	fármacos inmunosupresores	SINTOMA
alteraciones inespecíficas de la onda T	alteraciones inespecíficas de la onda T	SINTOMA
quimioterapia	quimioterapia	SINTOMA
proteína	proteína	SINTOMA
osteoporosis	osteoporosis	SINTOMA
diálisis	diálisis	SINTOMA
cistectomía transuretral	cistectomía transuretral	SINTOMA
TAC	TAC	SINTOMA
urea	urea	SINTOMA
insuficiencia respiratoria hipóxica	insuficiencia respiratoria hipóxica	SINTOMA
profilaxis antitrombótica	profilaxis antitrombótica	SINTOMA
74 anos	74 anos	SINTOMA
microtrombos pulmonares	microtrombos pulmonares	SINTOMA
clozapina	clozapina	SINTOMA
TSH	TSH	SINTOMA
56 anos	56 anos	SINTOMA
amoxicilina	amoxicilina	SINTOMA
T totales	T totales	SINTOMA
sudoración	sudoración	SINTOMA
alteraciones electrolíticas	alteraciones electrolíticas	SINTOMA
epistaxis en las extremidades inferiores (enfermedad)	epistaxis en las extremidades inferiores	ENFERMEDAD
epistaxis en las extremidades inferiores (sintoma)	epistaxis en las extremidades inferiores	SINTOMA
seroalbúmina	seroalbúmina	SINTOMA
TAC cerebral	TAC cerebral	SINTOMA
omeprazol	omeprazol	SINTOMA
43 anos	43 anos	SINTOMA
infección bacteriana	infección bacteriana	SINTOMA
alteraciones cutáneas	alteraciones cutáneas	SINTOMA
RMN torácica craneal y lumbar	RMN torácica craneal y lumbar	SINTOMA
ecografía torácica	ecografía torácica	SINTOMA
bacteremia por E coli	bacteremia por E coli	SINTOMA
mioglobina	mioglobina	SINTOMA
vasopresores	vasopresores	SINTOMA
hospital e prontosocorro delphina rinaldi abdel aziz	hospital e prontosocorro delphina rinaldi abdel aziz	SINTOMA
auscultación cardiopulmonar	auscultación cardiopulmonar	SINTOMA
poliuria	poliuria	SINTOMA
colestasis	colestasis	SINTOMA
staphylococcus aureus	staphylococcus aureus	SINTOMA
asma leve intermitente	asma leve intermitente	SINTOMA
exploración clínica	exploración clínica	SINTOMA
ventilación protectora	ventilación protectora	SINTOMA
infección vírica	infección vírica	SINTOMA
psoriasis crónica en placas moderada	psoriasis crónica en placas moderada	SINTOMA
infiltrados pulmonares	infiltrados pulmonares	SINTOMA
eritema polimorfo grave	eritema polimorfo grave	SINTOMA
46 anos	46 anos	SINTOMA
nina	nina	SINTOMA
hipertermia	hipertermia	SINTOMA
nino	nino	SINTOMA
síndrome de dificultad respiratoria aguda	síndrome de dificultad respiratoria aguda	SINTOMA
ageusia	ageusia	SINTOMA
afasia global	afasia global	SINTOMA
ciclofosfamida	ciclofosfamida	SINTOMA
nefropatía por IgA	nefropatía por IgA	SINTOMA
betametasona	betametasona	SINTOMA
taquicardia ventricular	taquicardia ventricular	SINTOMA
C koseri	C koseri	SINTOMA
respiración asistida	respiración asistida	SINTOMA
83 anos	83 anos	SINTOMA
61 anos	61 anos	SINTOMA
1 de febrero	1 de febrero	SINTOMA
bradicardia (enfermedad)	bradicardia	ENFERMEDAD
bradicardia (sintoma)	bradicardia	SINTOMA
disminución de la asat	disminución de la asat	SINTOMA
debilidad general	debilidad general	SINTOMA
tromboembolia pulmonar	tromboembolia pulmonar	SINTOMA
resonancia magnética cardiaca	resonancia magnética cardiaca	SINTOMA
moxifloxacina	moxifloxacina	SINTOMA
hipertensión	hipertensión	SINTOMA
moxifloxacino (farmaco)	moxifloxacino	FARMACO
moxifloxacino (proteinas)	moxifloxacino	PROTEINAS
pncnt	pncnt	PROTEINAS
retracción subcostal	retracción subcostal	PROTEINAS
aumento de la concentración de dímero D en	aumento de la concentración de dímero D en	PROTEINAS
19 de abril de 2020	19 de abril de 2020	PROTEINAS
diabetes mellitus	diabetes mellitus	PROTEINAS
tocilizumab (farmaco)	tocilizumab	FARMACO
tocilizumab (proteinas)	tocilizumab	PROTEINAS
29	29	PROTEINAS
coinfecciones	coinfecciones	PROTEINAS
aumento de LDH	aumento de LDH	PROTEINAS
14 de abril	14 de abril	PROTEINAS
hipertrofia biventricular	hipertrofia biventricular	PROTEINAS
infección respiratoria	infección respiratoria	PROTEINAS
72 anos	72 anos	PROTEINAS
tos no productiva	tos no productiva	PROTEINAS
angiotomografía computarizada coronaria	angiotomografía computarizada coronaria	PROTEINAS
metildopa	metildopa	PROTEINAS
coagulación intravascular generalizada	coagulación intravascular generalizada	PROTEINAS
13 de marzo	13 de marzo	PROTEINAS
sulfato de hidroxicloroquina	sulfato de hidroxicloroquina	PROTEINAS
42 anos	42 anos	PROTEINAS
8 de marzo	8 de marzo	PROTEINAS
edema cerebral	edema cerebral	PROTEINAS
ecografía pulmonar	ecografía pulmonar	PROTEINAS
empeoramiento del estado respiratorio	empeoramiento del estado respiratorio	PROTEINAS
acidosis metabólica	acidosis metabólica	PROTEINAS
lesión miocárdica	lesión miocárdica	PROTEINAS
dolor abdominal	dolor abdominal	PROTEINAS
ausencia de reflejos osteotendinosos	ausencia de reflejos osteotendinosos	PROTEINAS
EE	EE	PROTEINAS
alzheimer	alzheimer	PROTEINAS
51 anos	51 anos	PROTEINAS
paro cardíaco	paro cardíaco	PROTEINAS
ecocardiografía a pie de cama	ecocardiografía a pie de cama	PROTEINAS
confusión	confusión	PROTEINAS
interferón alfa2b (farmaco)	interferón alfa2b	FARMACO
interferón alfa2b (proteinas)	interferón alfa2b	PROTEINAS
análisis del líquido cefalorraquídeo	análisis del líquido cefalorraquídeo	PROTEINAS
erupción de placas eritematosas pruriginosas extendidas	erupción de placas eritematosas pruriginosas extendidas	PROTEINAS
RMN medular	RMN medular	PROTEINAS
hipovolemia	hipovolemia	PROTEINAS
interferón (farmaco)	interferón	FARMACO
interferón (proteinas)	interferón	PROTEINAS
citometría de flujo	citometría de flujo	PROTEINAS
opresión torácica	opresión torácica	PROTEINAS
extubación	extubación	PROTEINAS
amoxicilinaácido clavulánico	amoxicilinaácido clavulánico	PROTEINAS
del enfermo eutiroideo	del enfermo eutiroideo	PROTEINAS
adenovirus	adenovirus	PROTEINAS
ecografía abdominal	ecografía abdominal	PROTEINAS
rtpcr (procedimiento)	rtpcr	PROCEDIMIENTO
rtpcr (proteinas)	rtpcr	PROTEINAS
oliguria	oliguria	PROTEINAS
dexametasona	dexametasona	PROTEINAS
adenopatía en el lado derecho del cuello	adenopatía en el lado derecho del cuello	PROTEINAS
mascarilla N95	mascarilla N95	PROTEINAS
PCR de otros virus respiratorios	PCR de otros virus respiratorios	PROTEINAS
Kit	Kit	PROTEINAS
inmunoglobulina G	inmunoglobulina G	PROTEINAS
ventilación mecánica positiva continua	ventilación mecánica positiva continua	PROTEINAS
administró oxígeno	administró oxígeno	PROTEINAS
angiografía pulmonar	angiografía pulmonar	PROTEINAS
5 de febrero	5 de febrero	PROTEINAS
daegu	daegu	PROTEINAS
hongos	hongos	PROTEINAS
animales	animales	PROTEINAS
ventilación mecánica invasiva	ventilación mecánica invasiva	PROTEINAS
vírico	vírico	PROTEINAS
afroamericana	afroamericana	PROTEINAS
afecciones cardiopulmonares agudas	afecciones cardiopulmonares agudas	PROTEINAS
auscultación pulmonar	auscultación pulmonar	PROTEINAS
análisis de orina	análisis de orina	PROTEINAS
hemograma	hemograma	PROTEINAS
57 anos	57 anos	PROTEINAS
linfoadenopatía (enfermedad)	linfoadenopatía	ENFERMEDAD
linfoadenopatía (sintoma)	linfoadenopatía	SINTOMA
aspartatotransaminasa	aspartatotransaminasa	SINTOMA
disnea de esfuerzo	disnea de esfuerzo	SINTOMA
elevación difusa del segmento ST	elevación difusa del segmento ST	SINTOMA
análisis microbiológicos	análisis microbiológicos	SINTOMA
intoxicación por litio	intoxicación por litio	SINTOMA
sobreinfección	sobreinfección	SINTOMA
metaneumovirus humano	metaneumovirus humano	SINTOMA
30 de enero	30 de enero	SINTOMA
aciclovir	aciclovir	SINTOMA
decilitro	decilitro	SINTOMA
embolia pulmonar	embolia pulmonar	SINTOMA
obesidad	obesidad	SINTOMA
frotis faríngeo	frotis faríngeo	SINTOMA
16 de febrero	16 de febrero	SINTOMA
prueba de covid19	prueba de covid19	SINTOMA
transfusión de plasma	transfusión de plasma	SINTOMA
benzonatato	benzonatato	SINTOMA
óxido	óxido	SINTOMA
alanina	alanina	SINTOMA
vinc	vinc	SINTOMA
PCR de frotis nasofaríngeo	PCR de frotis nasofaríngeo	SINTOMA
hipoalbuminemia (enfermedad)	hipoalbuminemia	ENFERMEDAD
hipoalbuminemia (sintoma)	hipoalbuminemia	SINTOMA
insuficiencia respiratoria aguda	insuficiencia respiratoria aguda	SINTOMA
sobrepeso	sobrepeso	SINTOMA
febril	febril	SINTOMA
administración de tensioactivos	administración de tensioactivos	SINTOMA
dispepsia (enfermedad)	dispepsia	ENFERMEDAD
dispepsia (sintoma)	dispepsia	SINTOMA
anasarca	anasarca	SINTOMA
angiografía coronaria	angiografía coronaria	SINTOMA
análisis citológico	análisis citológico	SINTOMA
erupción farmacológica	erupción farmacológica	SINTOMA
antígeno A	antígeno A	SINTOMA
bloqueo de la rama derecha del haz de His	bloqueo de la rama derecha del haz de His	SINTOMA
10 de marzo	10 de marzo	SINTOMA
ANA	ANA	SINTOMA
troponina T	troponina T	SINTOMA
4 de marzo	4 de marzo	SINTOMA
troponina	troponina	SINTOMA
diabetes mellitus de tipo 2	diabetes mellitus de tipo 2	SINTOMA
aumento de la cifra de eritrocitos	aumento de la cifra de eritrocitos	SINTOMA
troponina I	troponina I	SINTOMA
intubación orotraqueal	intubación orotraqueal	SINTOMA
50 anos	50 anos	SINTOMA
hidratación iv	hidratación iv	SINTOMA
pruebas de autoanticuerpos y de virus cardiotrópicos	pruebas de autoanticuerpos y de virus cardiotrópicos	SINTOMA
CPK	CPK	SINTOMA
legionella	legionella	SINTOMA
5fluorouracil	5fluorouracil	SINTOMA
anticuerpos antcd20	anticuerpos antcd20	SINTOMA
pruebas microbiológicas de LCR	pruebas microbiológicas de LCR	SINTOMA
aptc de doble energía	aptc de doble energía	SINTOMA
15 de mayo	15 de mayo	SINTOMA
aspiración del esputo	aspiración del esputo	SINTOMA
insuficiencia respiratoria hipoxémica	insuficiencia respiratoria hipoxémica	SINTOMA
terapia antibiótica	terapia antibiótica	SINTOMA
ácido acetilsalicílico	ácido acetilsalicílico	SINTOMA
15 anos	15 anos	SINTOMA
dolor en fosa lumbar	dolor en fosa lumbar	SINTOMA
anticoagulantes	anticoagulantes	SINTOMA
cardiopatías	cardiopatías	SINTOMA
incapacidad de andar	incapacidad de andar	SINTOMA
7 anos	7 anos	SINTOMA
fusarium proliferatum	fusarium proliferatum	SINTOMA
desmayó	desmayó	SINTOMA
hipertensión pulmonar	hipertensión pulmonar	SINTOMA
dermatosis inflamatorias	dermatosis inflamatorias	SINTOMA
ganciclovir	ganciclovir	SINTOMA
euroimmun	euroimmun	SINTOMA
pruebas serológicas	pruebas serológicas	SINTOMA
síndrome respiratorio agudo grave	síndrome respiratorio agudo grave	SINTOMA
alopurinol	alopurinol	SINTOMA
rigidez	rigidez	SINTOMA
análisis histopatológico de la tromboembolectomía	análisis histopatológico de la tromboembolectomía	SINTOMA
olanzapina	olanzapina	SINTOMA
claustrofobia	claustrofobia	SINTOMA
tromboplastina	tromboplastina	SINTOMA
O2	O2	SINTOMA
cardiotocografía	cardiotocografía	SINTOMA
eritema	eritema	SINTOMA
arritmias	arritmias	SINTOMA
oxigenación por membrana extracorporal	oxigenación por membrana extracorporal	SINTOMA
mujer	mujer	SINTOMA
potasio	potasio	SINTOMA
trombosis venosa	trombosis venosa	SINTOMA
febrero	febrero	SINTOMA
choque cardiogénico	choque cardiogénico	SINTOMA
ferritina	ferritina	SINTOMA
delirio confusional (enfermedad)	delirio confusional	ENFERMEDAD
delirio confusional (sintoma)	delirio confusional	SINTOMA
electroencefalograma	electroencefalograma	SINTOMA
proteínas de la fase aguda	proteínas de la fase aguda	SINTOMA
insuficiencia mitral	insuficiencia mitral	SINTOMA
transaminasas	transaminasas	SINTOMA
administró oxígeno y antibióticos	administró oxígeno y antibióticos	SINTOMA
neumonía intersticial bilateral	neumonía intersticial bilateral	SINTOMA
virus de la hepatitis B	virus de la hepatitis B	SINTOMA
estudios de conducción nerviosa sensorial	estudios de conducción nerviosa sensorial	SINTOMA
evaluación neurológica	evaluación neurológica	SINTOMA
insuficiencia renal aguda	insuficiencia renal aguda	SINTOMA
TAC torácica	TAC torácica	SINTOMA
TCA superior	TCA superior	SINTOMA
falta de apetito	falta de apetito	SINTOMA
frotis de sangre	frotis de sangre	SINTOMA
70 anos	70 anos	SINTOMA
signo de lasègue	signo de lasègue	SINTOMA
neutrofilia	neutrofilia	SINTOMA
virus	virus	SINTOMA
angiotomografía craneomaxilofacial	angiotomografía craneomaxilofacial	SINTOMA
miocarditis	miocarditis	SINTOMA
deshidratación	deshidratación	SINTOMA
taquicardia fetal	taquicardia fetal	SINTOMA
albúmina (farmaco)	albúmina	FARMACO
albúmina (proteinas)	albúmina	PROTEINAS
tratamiento anticoagulante	tratamiento anticoagulante	PROTEINAS
sobreinfecciones	sobreinfecciones	PROTEINAS
probnp (farmaco)	probnp	FARMACO
probnp (proteinas)	probnp	PROTEINAS
10 de febrero	10 de febrero	PROTEINAS
angiografía por resonancia magnética	angiografía por resonancia magnética	PROTEINAS
hipocinesia de los segmentos inferior e inferolateral del ventrículo (enfermedad)	hipocinesia de los segmentos inferior e inferolateral del ventrículo	ENFERMEDAD
hipocinesia de los segmentos inferior e inferolateral del ventrículo (sintoma)	hipocinesia de los segmentos inferior e inferolateral del ventrículo	SINTOMA
arteriopatía periférica	arteriopatía periférica	SINTOMA
dilatación del ventrículo	dilatación del ventrículo	SINTOMA
febrícula	febrícula	SINTOMA
anticuerpos antinucleares	anticuerpos antinucleares	SINTOMA
noradrenalina	noradrenalina	SINTOMA
miopericarditis	miopericarditis	SINTOMA
dilatación coronaria	dilatación coronaria	SINTOMA
27 de febrero	27 de febrero	SINTOMA
dolor a la palpación	dolor a la palpación	SINTOMA
neumonía extrahospitalaria	neumonía extrahospitalaria	SINTOMA
28 de febrero	28 de febrero	SINTOMA
gadolinio	gadolinio	SINTOMA
5 anos	5 anos	SINTOMA
18 de abril	18 de abril	SINTOMA
signos respiratorios	signos respiratorios	SINTOMA
desorientación	desorientación	SINTOMA
anticuerpos antigangliósidos	anticuerpos antigangliósidos	SINTOMA
fibrinógeno	fibrinógeno	SINTOMA
1 de febrero de 2020	1 de febrero de 2020	SINTOMA
paraplejia	paraplejia	SINTOMA
alerta	alerta	SINTOMA
ixekizumab	ixekizumab	SINTOMA
cesárea	cesárea	SINTOMA
RMN cardiaca	RMN cardiaca	SINTOMA
encefalitis	encefalitis	SINTOMA
hipertonía	hipertonía	SINTOMA
shanghai	shanghai	SINTOMA
infección por sarscov2	infección por sarscov2	SINTOMA
infiltrados alveolares	infiltrados alveolares	SINTOMA
TAC torácica y abdominal	TAC torácica y abdominal	SINTOMA
paro cardíaco súbito	paro cardíaco súbito	SINTOMA
aislamiento respiratorio	aislamiento respiratorio	SINTOMA
polimerasa	polimerasa	SINTOMA
tratamiento local con corticosteroides	tratamiento local con corticosteroides	SINTOMA
21 de enero de 2020	21 de enero de 2020	SINTOMA
64 anos	64 anos	SINTOMA
18 de febrero de 2020	18 de febrero de 2020	SINTOMA
troponina I ultrasensible	troponina I ultrasensible	SINTOMA
PCR del LCR	PCR del LCR	SINTOMA
somnoliento	somnoliento	SINTOMA
dificultad respiratoria aguda	dificultad respiratoria aguda	SINTOMA
inflamación intersticial bilateral difusa con consolidaciones subpleurales	inflamación intersticial bilateral difusa con consolidaciones subpleurales	SINTOMA
dolor abdominal en el área epigástrica	dolor abdominal en el área epigástrica	SINTOMA
fentanilo	fentanilo	SINTOMA
anomalía en el tabique auricular	anomalía en el tabique auricular	SINTOMA
microlitro	microlitro	SINTOMA
esteroides oftálmicos	esteroides oftálmicos	SINTOMA
caída de la saturación de oxígeno	caída de la saturación de oxígeno	SINTOMA
anticuerpos de covid19	anticuerpos de covid19	SINTOMA
disfunción esfinteriana	disfunción esfinteriana	SINTOMA
letargia	letargia	SINTOMA
estudio de conducción nerviosa	estudio de conducción nerviosa	SINTOMA
hormonas tiroideas	hormonas tiroideas	SINTOMA
síndrome de dificultad respiratoria aguda por coronavirus 2	síndrome de dificultad respiratoria aguda por coronavirus 2	SINTOMA
anosmiaageusia	anosmiaageusia	SINTOMA
preeclampsia	preeclampsia	SINTOMA
108h	108h	SINTOMA
parálisis facial	parálisis facial	SINTOMA
meropenem	meropenem	SINTOMA
nefropatía crónica	nefropatía crónica	SINTOMA
ecocardiograma transtorácico	ecocardiograma transtorácico	SINTOMA
SMX	SMX	SINTOMA
descenso del segmento ST en v2v4	descenso del segmento ST en v2v4	SINTOMA
TAC pulmonar	TAC pulmonar	SINTOMA
albuterol	albuterol	SINTOMA
parto vaginal (enfermedad)	parto vaginal	ENFERMEDAD
parto vaginal (procedimiento)	parto vaginal	PROCEDIMIENTO
ansiedad (enfermedad)	ansiedad	ENFERMEDAD
ansiedad (sintoma)	ansiedad	SINTOMA
esteroides (farmaco)	esteroides	FARMACO
esteroides (procedimiento)	esteroides	PROCEDIMIENTO
antibiótico	antibiótico	PROCEDIMIENTO
biopsias de los pulmones	biopsias de los pulmones	PROCEDIMIENTO
TAC torácicas abdominal y pélvica con contraste	TAC torácicas abdominal y pélvica con contraste	PROCEDIMIENTO
dificultad respiratoria	dificultad respiratoria	PROCEDIMIENTO
vómitos	vómitos	PROCEDIMIENTO
ácido láctico	ácido láctico	PROCEDIMIENTO
bulto en crecimiento palpable en su región parietal	bulto en crecimiento palpable en su región parietal	PROCEDIMIENTO
2 de febrero de 2020	2 de febrero de 2020	PROCEDIMIENTO
arteriopatía coronaria obstructiva	arteriopatía coronaria obstructiva	PROCEDIMIENTO
estertores bibasales	estertores bibasales	PROCEDIMIENTO
24 de marzo de 2020	24 de marzo de 2020	PROCEDIMIENTO
tratamiento antibacteriano	tratamiento antibacteriano	PROCEDIMIENTO
TAC de alta resolución	TAC de alta resolución	PROCEDIMIENTO
neumonía vírica	neumonía vírica	PROCEDIMIENTO
ALT	ALT	PROCEDIMIENTO
34 anos	34 anos	PROCEDIMIENTO
orientado	orientado	PROCEDIMIENTO
22 de marzo de 2020	22 de marzo de 2020	PROCEDIMIENTO
ácido clavulánico	ácido clavulánico	PROCEDIMIENTO
milrinona	milrinona	PROCEDIMIENTO
PCR en exudado nasofaríngeo	PCR en exudado nasofaríngeo	PROCEDIMIENTO
hemocultivo	hemocultivo	PROCEDIMIENTO
aspirina	aspirina	PROCEDIMIENTO
drenaje torácico	drenaje torácico	PROCEDIMIENTO
leucocitopenia (enfermedad)	leucocitopenia	ENFERMEDAD
leucocitopenia (proteinas)	leucocitopenia	PROTEINAS
leucocitopenia (sintoma)	leucocitopenia	SINTOMA
T citotóxicos	T citotóxicos	SINTOMA
RMN cerebral y raquídea	RMN cerebral y raquídea	SINTOMA
vancomicina	vancomicina	SINTOMA
84 anos	84 anos	SINTOMA
interferón beta (farmaco)	interferón beta	FARMACO
interferón beta (proteinas)	interferón beta	PROTEINAS
hemorragia	hemorragia	PROTEINAS
síndrome de guillainbarré	síndrome de guillainbarré	PROTEINAS
frotis nasofaríngeo para sarscov2	frotis nasofaríngeo para sarscov2	PROTEINAS
lesión renal aguda	lesión renal aguda	PROTEINAS
lactato	lactato	PROTEINAS
59 anos	59 anos	PROTEINAS
ampa12	ampa12	PROTEINAS
análisis completo autoinmunitario	análisis completo autoinmunitario	PROTEINAS
hipoxia	hipoxia	PROTEINAS
tuberculosis	tuberculosis	PROTEINAS
antibióticos y antifúngicos	antibióticos y antifúngicos	PROTEINAS
bicarbonato sódico	bicarbonato sódico	PROTEINAS
cansancio	cansancio	PROTEINAS
2017	2017	PROTEINAS
neuropatía desmielinizante	neuropatía desmielinizante	PROTEINAS
colitis ulcerosa	colitis ulcerosa	PROTEINAS
rinorrea	rinorrea	PROTEINAS
náuseas	náuseas	PROTEINAS
neumotórax	neumotórax	PROTEINAS
conjuntivitis	conjuntivitis	PROTEINAS
exploración física	exploración física	PROTEINAS
aspartatoaminotransferasa–	aspartatoaminotransferasa–	PROTEINAS
duplicidad renal	duplicidad renal	PROTEINAS
VIH	VIH	PROTEINAS
cáncer de próstata	cáncer de próstata	PROTEINAS
ecografía renal	ecografía renal	PROTEINAS
alteración de la capacidad hepática y renal	alteración de la capacidad hepática y renal	PROTEINAS
carcinoma de células escamosas hipofaríngeo	carcinoma de células escamosas hipofaríngeo	PROTEINAS
pruebas funcionales hepáticas	pruebas funcionales hepáticas	PROTEINAS
infarto agudo	infarto agudo	PROTEINAS
déficit de atención (enfermedad)	déficit de atención	ENFERMEDAD
déficit de atención (sintoma)	déficit de atención	SINTOMA
estudios de coagulación	estudios de coagulación	SINTOMA
enzimas hepáticas	enzimas hepáticas	SINTOMA
nefropatía	nefropatía	SINTOMA
mareo	mareo	SINTOMA
exploración torácica	exploración torácica	SINTOMA
aguda	aguda	SINTOMA
espiramicina	espiramicina	SINTOMA
ventilación invasiva	ventilación invasiva	SINTOMA
esclerosis múltiple	esclerosis múltiple	SINTOMA
disminución de los marcadores inflamatorios	disminución de los marcadores inflamatorios	SINTOMA
intubación	intubación	SINTOMA
eltrombopag	eltrombopag	SINTOMA
anemia normocítica leve	anemia normocítica leve	SINTOMA
antibióticos iv	antibióticos iv	SINTOMA
estenosis focal moderada de la ACM	estenosis focal moderada de la ACM	SINTOMA
fatiga	fatiga	SINTOMA
anomalía intracraneal aguda	anomalía intracraneal aguda	SINTOMA
dobutamina	dobutamina	SINTOMA
aortitis autoinmunitaria de la aorta abdominal	aortitis autoinmunitaria de la aorta abdominal	SINTOMA
fumadora	fumadora	SINTOMA
16 de marzo	16 de marzo	SINTOMA
mayo de 2020	mayo de 2020	SINTOMA
tos persistente	tos persistente	SINTOMA
malestar intenso	malestar intenso	SINTOMA
angustia	angustia	SINTOMA
cardiopatía isquémica	cardiopatía isquémica	SINTOMA
ampicilina	ampicilina	SINTOMA
análisis de líquido cefalorraquídeo	análisis de líquido cefalorraquídeo	SINTOMA
restricción hídrica	restricción hídrica	SINTOMA
disfunción ventricular	disfunción ventricular	SINTOMA
enero de 2020	enero de 2020	SINTOMA
polonia	polonia	SINTOMA
síntomas gastrointestinales	síntomas gastrointestinales	SINTOMA
auscultación torácica	auscultación torácica	SINTOMA
rehabilitación de covid19	rehabilitación de covid19	SINTOMA
administración de heparina de bajo peso molecular	administración de heparina de bajo peso molecular	SINTOMA
prednisona	prednisona	SINTOMA
oxigenoterapia nasal	oxigenoterapia nasal	SINTOMA
trombocitopenia (enfermedad)	trombocitopenia	ENFERMEDAD
trombocitopenia (sintoma)	trombocitopenia	SINTOMA
deshidrogenasa láctica	deshidrogenasa láctica	SINTOMA
tratamiento antibiótico	tratamiento antibiótico	SINTOMA
ampar	ampar	SINTOMA
treponema pallidum	treponema pallidum	SINTOMA
crisis epiléptica	crisis epiléptica	SINTOMA
alemania (pais)	alemania	PAIS
alemania (proteinas)	alemania	PROTEINAS
inmunoglobulina (farmaco)	inmunoglobulina	FARMACO
inmunoglobulina (proteinas)	inmunoglobulina	PROTEINAS
broncoscopia	broncoscopia	PROTEINAS
abril de 2020	abril de 2020	PROTEINAS
heparina	heparina	PROTEINAS
il6	il6	PROTEINAS
hioscina	hioscina	PROTEINAS
cardiomiopatía isquémica	cardiomiopatía isquémica	PROTEINAS
neumonía	neumonía	PROTEINAS
27 anos	27 anos	PROTEINAS
prueba de sarscov2 mediante rtpcr	prueba de sarscov2 mediante rtpcr	PROTEINAS
chlamydia pneumoniae	chlamydia pneumoniae	PROTEINAS
ampicilinaácido clavulánico	ampicilinaácido clavulánico	PROTEINAS
mesalazina	mesalazina	PROTEINAS
hemodiálisis	hemodiálisis	PROTEINAS
prohormona nterminal	prohormona nterminal	PROTEINAS
leucocitosis (enfermedad)	leucocitosis	ENFERMEDAD
leucocitosis (sintoma)	leucocitosis	SINTOMA
humano	humano	SINTOMA
asma grave	asma grave	SINTOMA
acroisquemia persistente bilateral de las extremidades inferiores	acroisquemia persistente bilateral de las extremidades inferiores	SINTOMA
cultivos de esputo	cultivos de esputo	SINTOMA
neumonía por covid19	neumonía por covid19	SINTOMA
alteraciones isquémicas en la región irrigada por la arteria cerebral	alteraciones isquémicas en la región irrigada por la arteria cerebral	SINTOMA
desorientado	desorientado	SINTOMA
diabetes de tipo 2	diabetes de tipo 2	SINTOMA
RMN cerebral	RMN cerebral	SINTOMA
catéter urinario	catéter urinario	SINTOMA
dímerod	dímerod	SINTOMA
angina vasoespástica	angina vasoespástica	SINTOMA
biopsia cutánea	biopsia cutánea	SINTOMA
cribaje genético	cribaje genético	SINTOMA
neumonía multifocal	neumonía multifocal	SINTOMA
tabaquismo (enfermedad)	tabaquismo	ENFERMEDAD
tabaquismo (sintoma)	tabaquismo	SINTOMA
insuficiencia circulatoria	insuficiencia circulatoria	SINTOMA
hepatomegalia (enfermedad)	hepatomegalia	ENFERMEDAD
hepatomegalia (sintoma)	hepatomegalia	SINTOMA
gabapentina	gabapentina	SINTOMA
frotis faríngeos	frotis faríngeos	SINTOMA
metotrexato	metotrexato	SINTOMA
CD4	CD4	SINTOMA
delirio (enfermedad)	delirio	ENFERMEDAD
delirio (sintoma)	delirio	SINTOMA
análisis serológico	análisis serológico	SINTOMA
levetiracetam	levetiracetam	SINTOMA
sobreinfecciones bacterianas	sobreinfecciones bacterianas	SINTOMA
pruebas hematológicas	pruebas hematológicas	SINTOMA
exploración cardiaca	exploración cardiaca	SINTOMA
2016	2016	SINTOMA
CDC	CDC	SINTOMA
de la sexta vértebra torácica	de la sexta vértebra torácica	SINTOMA
síndrome respiratorio agudo grave por coronavirus 2	síndrome respiratorio agudo grave por coronavirus 2	SINTOMA
interleucina 6	interleucina 6	SINTOMA
de aspergillus	de aspergillus	SINTOMA
parto (enfermedad)	parto	ENFERMEDAD
parto (procedimiento)	parto	PROCEDIMIENTO
ensayo rtpcr del LCR	ensayo rtpcr del LCR	PROCEDIMIENTO
alaninatransaminasa	alaninatransaminasa	PROCEDIMIENTO
RMN cerebrales	RMN cerebrales	PROCEDIMIENTO
tratamiento diurético	tratamiento diurético	PROCEDIMIENTO
cambios en su frecuencia de orina y defecaciones	cambios en su frecuencia de orina y defecaciones	PROCEDIMIENTO
sodio	sodio	PROCEDIMIENTO
diabetes	diabetes	PROCEDIMIENTO
frotis nasofaríngeo y orofaríngeo	frotis nasofaríngeo y orofaríngeo	PROCEDIMIENTO
solución salina	solución salina	PROCEDIMIENTO
afebril	afebril	PROCEDIMIENTO
ARM	ARM	PROCEDIMIENTO
disminución de la saturación de oxígeno	disminución de la saturación de oxígeno	PROCEDIMIENTO
anticuerpos antitirosina fosfatasa IA2	anticuerpos antitirosina fosfatasa IA2	PROCEDIMIENTO
epinefrina	epinefrina	PROCEDIMIENTO
dolor epigástrico	dolor epigástrico	PROCEDIMIENTO
disfagia	disfagia	PROCEDIMIENTO
ciclesonida	ciclesonida	PROCEDIMIENTO
hiperglucemia (enfermedad)	hiperglucemia	ENFERMEDAD
hiperglucemia (sintoma)	hiperglucemia	SINTOMA
buen apetito	buen apetito	SINTOMA
cultivos víricos de esputo y secreciones nasofaríngeas	cultivos víricos de esputo y secreciones nasofaríngeas	SINTOMA
trasplante renal	trasplante renal	SINTOMA
prednisolona	prednisolona	SINTOMA
signo de babinski	signo de babinski	SINTOMA
linfoma de células del manto	linfoma de células del manto	SINTOMA
somnolencia	somnolencia	SINTOMA
aumento de la proteína creactiva	aumento de la proteína creactiva	SINTOMA
macrohematuria (enfermedad)	macrohematuria	ENFERMEDAD
macrohematuria (sintoma)	macrohematuria	SINTOMA
cultivos de LCR	cultivos de LCR	SINTOMA
trastorno esquizoafectivo	trastorno esquizoafectivo	SINTOMA
14 de marzo	14 de marzo	SINTOMA
expectoración hemoptoica	expectoración hemoptoica	SINTOMA
ecografía	ecografía	SINTOMA
parto por cesárea (enfermedad)	parto por cesárea	ENFERMEDAD
parto por cesárea (procedimiento)	parto por cesárea	PROCEDIMIENTO
taquicardia sinusal	taquicardia sinusal	PROCEDIMIENTO
EEG	EEG	PROCEDIMIENTO
35 anos	35 anos	PROCEDIMIENTO
hiposmia (enfermedad)	hiposmia	ENFERMEDAD
hiposmia (sintoma)	hiposmia	SINTOMA
embarazo (enfermedad)	embarazo	ENFERMEDAD
embarazo (sintoma)	embarazo	SINTOMA
anestesia general	anestesia general	SINTOMA
fibrilación auricular	fibrilación auricular	SINTOMA
PCR de las heces	PCR de las heces	SINTOMA
16 de abril de 2020	16 de abril de 2020	SINTOMA
25 de febrero	25 de febrero	SINTOMA
chlamydia	chlamydia	SINTOMA
cefepima	cefepima	SINTOMA
TVP	TVP	SINTOMA
proteinuria	proteinuria	SINTOMA
pruebas de esputo	pruebas de esputo	SINTOMA
corticoesteroides (farmaco)	corticoesteroides	FARMACO
corticoesteroides (procedimiento)	corticoesteroides	PROCEDIMIENTO
diabetes gestacional	diabetes gestacional	PROCEDIMIENTO
clorhidrato de ambroxol	clorhidrato de ambroxol	PROCEDIMIENTO
muerte	muerte	PROCEDIMIENTO
ventilación no invasiva	ventilación no invasiva	PROCEDIMIENTO
receptor de la interleucina 6	receptor de la interleucina 6	PROCEDIMIENTO
irritabilidad	irritabilidad	PROCEDIMIENTO
vasculitis	vasculitis	PROCEDIMIENTO
aislamiento domiciliario	aislamiento domiciliario	PROCEDIMIENTO
TAC torácica de corte fino	TAC torácica de corte fino	PROCEDIMIENTO
aumento de leucocitos	aumento de leucocitos	PROCEDIMIENTO
telemetría	telemetría	PROCEDIMIENTO
fiebre	fiebre	PROCEDIMIENTO
6 anos	6 anos	PROCEDIMIENTO
hemoptisis	hemoptisis	PROCEDIMIENTO
enfermedades infecciosas	enfermedades infecciosas	PROCEDIMIENTO
debilidad distal en las extremidades superiores	debilidad distal en las extremidades superiores	PROCEDIMIENTO
cultivo de LCR	cultivo de LCR	PROCEDIMIENTO
aumento de fibrinógeno dímero D y proteína creactiva	aumento de fibrinógeno dímero D y proteína creactiva	PROCEDIMIENTO
nitrógeno	nitrógeno	PROCEDIMIENTO
cefotaxima	cefotaxima	PROCEDIMIENTO
ecocardiografía	ecocardiografía	PROCEDIMIENTO
hematuria (enfermedad)	hematuria	ENFERMEDAD
hematuria (sintoma)	hematuria	SINTOMA
66 anos	66 anos	SINTOMA
4 de febrero de 2020	4 de febrero de 2020	SINTOMA
aztreonam	aztreonam	SINTOMA
cobicistat	cobicistat	SINTOMA
liberación	liberación	SINTOMA
aumento de leucocitos y proteínas	aumento de leucocitos y proteínas	SINTOMA
