id	title	group	label
ecografia	ecografia	PROCEDIMIENTO	ecografia
anosmia (sintoma)	anosmia	SINTOMA	anosmia
aspirina	aspirina	FARMACO	aspirina
19 anos	19 anos	EDAD-SUJETO-ASISTENCIA	19 anos
hemodiafiltracion venovenosa continua	hemodiafiltracion venovenosa continua	PROCEDIMIENTO	hemodiafiltracion venovenosa continua
enfermedad pulmonar obstructiva cronica	enfermedad pulmonar obstructiva cronica	ENFERMEDAD	enfermedad pulmonar obstructiva cronica
TAC cerebral sin contraste	TAC cerebral sin contraste	PROCEDIMIENTO	TAC cerebral sin contraste
lopinavirritonavir	lopinavirritonavir	FARMACO	lopinavirritonavir
hipoxemia (enfermedad)	hipoxemia	ENFERMEDAD	hipoxemia
debilidad facial	debilidad facial	SINTOMA	debilidad facial
cateter urinario	cateter urinario	PROCEDIMIENTO	cateter urinario
ferritina serica	ferritina serica	ENTIDAD-OBSERVABLE	ferritina serica
ampicilinaacido clavulanico	ampicilinaacido clavulanico	FARMACO	ampicilinaacido clavulanico
frotis nasofaringeo	frotis nasofaringeo	PROCEDIMIENTO	frotis nasofaringeo
mascarilla de venturi	mascarilla de venturi	PROCEDIMIENTO	mascarilla de venturi
10 de mayo	10 de mayo	FECHAS	10 de mayo
troponina I ultrasensible	troponina I ultrasensible	PROTEINAS	troponina I ultrasensible
61 anos	61 anos	EDAD-SUJETO-ASISTENCIA	61 anos
glucocorticoides	glucocorticoides	FARMACO	glucocorticoides
asma grave	asma grave	ENFERMEDAD	asma grave
infeccion por covid19	infeccion por covid19	ENFERMEDAD	infeccion por covid19
6 anos	6 anos	EDAD-SUJETO-ASISTENCIA	6 anos
IL6 (entidad-observable)	IL6	ENTIDAD-OBSERVABLE	IL6
6 de febrero	6 de febrero	FECHAS	6 de febrero
nitrogeno	nitrogeno	FARMACO	nitrogeno
bacilos	bacilos	SPECIES	bacilos
gasometria	gasometria	PROCEDIMIENTO	gasometria
troponina I inicial	troponina I inicial	PROTEINAS	troponina I inicial
HIV	HIV	SPECIES	HIV
bloqueo de la rama derecha del haz de His	bloqueo de la rama derecha del haz de His	ENFERMEDAD	bloqueo de la rama derecha del haz de His
hba1c (entidad-observable)	hba1c	ENTIDAD-OBSERVABLE	hba1c
oxigenoterapia	oxigenoterapia	PROCEDIMIENTO	oxigenoterapia
analisis de sangre	analisis de sangre	PROCEDIMIENTO	analisis de sangre
delirio (sintoma)	delirio	SINTOMA	delirio
exploracion neurologica de las extremidades inferiores	exploracion neurologica de las extremidades inferiores	PROCEDIMIENTO	exploracion neurologica de las extremidades inferiores
interleucina (proteinas)	interleucina	PROTEINAS	interleucina
enfermedad por coronavirus 2019	enfermedad por coronavirus 2019	ENFERMEDAD	enfermedad por coronavirus 2019
4 de marzo	4 de marzo	FECHAS	4 de marzo
dolor en la pierna	dolor en la pierna	SINTOMA	dolor en la pierna
aumento de las necesidades de oxigeno	aumento de las necesidades de oxigeno	SINTOMA	aumento de las necesidades de oxigeno
resonancia magnetica cardiaca	resonancia magnetica cardiaca	PROCEDIMIENTO	resonancia magnetica cardiaca
cateter venoso en la vena yugular derecha	cateter venoso en la vena yugular derecha	PROCEDIMIENTO	cateter venoso en la vena yugular derecha
hangzhou	hangzhou	TERRITORIO	hangzhou
administro abipenem	administro abipenem	PROCEDIMIENTO	administro abipenem
anestesicos topicos	anestesicos topicos	PROCEDIMIENTO	anestesicos topicos
prueba de covid19	prueba de covid19	PROCEDIMIENTO	prueba de covid19
anomalias de la marcha	anomalias de la marcha	SINTOMA	anomalias de la marcha
PCR del LCR	PCR del LCR	PROCEDIMIENTO	PCR del LCR
proteinas	proteinas	PROTEINAS	proteinas
proteinas de la fase aguda	proteinas de la fase aguda	PROTEINAS	proteinas de la fase aguda
linfoadenopatia (enfermedad)	linfoadenopatia	ENFERMEDAD	linfoadenopatia
toxina de clostridium difficile	toxina de clostridium difficile	PROTEINAS	toxina de clostridium difficile
23 de marzo de 2020	23 de marzo de 2020	FECHAS	23 de marzo de 2020
aspergilosis	aspergilosis	ENFERMEDAD	aspergilosis
aumento del esfuerzo respiratorio	aumento del esfuerzo respiratorio	SINTOMA	aumento del esfuerzo respiratorio
fibrinogeno (entidad-observable)	fibrinogeno	ENTIDAD-OBSERVABLE	fibrinogeno
inflamacion intersticial bilateral difusa con consolidaciones subpleurales	inflamacion intersticial bilateral difusa con consolidaciones subpleurales	SINTOMA	inflamacion intersticial bilateral difusa con consolidaciones subpleurales
alerta	alerta	SINTOMA	alerta
brotizolam	brotizolam	FARMACO	brotizolam
desaturacion subita	desaturacion subita	ENFERMEDAD	desaturacion subita
108h	108h	PROTEINAS	108h
ribavirina	ribavirina	FARMACO	ribavirina
malestar toracico	malestar toracico	SINTOMA	malestar toracico
electrocardiograma	electrocardiograma	PROCEDIMIENTO	electrocardiograma
analisis de orina	analisis de orina	PROCEDIMIENTO	analisis de orina
terapia antibiotica	terapia antibiotica	PROCEDIMIENTO	terapia antibiotica
amoxicilina por via oral	amoxicilina por via oral	PROCEDIMIENTO	amoxicilina por via oral
infusion iv	infusion iv	PROCEDIMIENTO	infusion iv
alcoholismo	alcoholismo	ENFERMEDAD	alcoholismo
nefropatia	nefropatia	ENFERMEDAD	nefropatia
ventilacion mecanica positiva continua	ventilacion mecanica positiva continua	PROCEDIMIENTO	ventilacion mecanica positiva continua
citomegalovirus	citomegalovirus	SPECIES	citomegalovirus
Hb (entidad-observable)	Hb	ENTIDAD-OBSERVABLE	Hb
mayo	mayo	FECHAS	mayo
ferritina (proteinas)	ferritina	PROTEINAS	ferritina
trastorno psicotico	trastorno psicotico	ENFERMEDAD	trastorno psicotico
corioamnionitis	corioamnionitis	ENFERMEDAD	corioamnionitis
aumento de la lactatodeshidrogenasa	aumento de la lactatodeshidrogenasa	SINTOMA	aumento de la lactatodeshidrogenasa
aislamiento respiratorio	aislamiento respiratorio	PROCEDIMIENTO	aislamiento respiratorio
administracion oral	administracion oral	PROCEDIMIENTO	administracion oral
9 de marzo	9 de marzo	FECHAS	9 de marzo
exploracion fisica	exploracion fisica	PROCEDIMIENTO	exploracion fisica
10 de febrero	10 de febrero	FECHAS	10 de febrero
enero	enero	FECHAS	enero
tabaquismo (enfermedad)	tabaquismo	ENFERMEDAD	tabaquismo
rinorrea	rinorrea	SINTOMA	rinorrea
dorsalgia en la zona dorsallumbar	dorsalgia en la zona dorsallumbar	SINTOMA	dorsalgia en la zona dorsallumbar
20 de febrero	20 de febrero	FECHAS	20 de febrero
pruebas serologicas	pruebas serologicas	PROCEDIMIENTO	pruebas serologicas
captopril	captopril	FARMACO	captopril
dislipidemia	dislipidemia	ENFERMEDAD	dislipidemia
bilioso	bilioso	SINTOMA	bilioso
exfumador	exfumador	ENFERMEDAD	exfumador
clindamicina	clindamicina	FARMACO	clindamicina
euroimmun	euroimmun	PROTEINAS	euroimmun
sindrome inflamatorio	sindrome inflamatorio	ENFERMEDAD	sindrome inflamatorio
miocarditis aguda	miocarditis aguda	ENFERMEDAD	miocarditis aguda
atrofia del musculo recto externo	atrofia del musculo recto externo	ENFERMEDAD	atrofia del musculo recto externo
diabetes mellitus de tipo 2	diabetes mellitus de tipo 2	ENFERMEDAD	diabetes mellitus de tipo 2
TSH (proteinas)	TSH	PROTEINAS	TSH
anemia grave	anemia grave	ENFERMEDAD	anemia grave
bacteremia por E coli	bacteremia por E coli	ENFERMEDAD	bacteremia por E coli
virus de coxsackie B	virus de coxsackie B	SPECIES	virus de coxsackie B
italia	italia	PAIS	italia
astenia	astenia	SINTOMA	astenia
rivaroxaban	rivaroxaban	FARMACO	rivaroxaban
betametasona dipropionato	betametasona dipropionato	FARMACO	betametasona dipropionato
neumonia grave	neumonia grave	ENFERMEDAD	neumonia grave
anemia aplasica grave	anemia aplasica grave	ENFERMEDAD	anemia aplasica grave
troponina (entidad-observable)	troponina	ENTIDAD-OBSERVABLE	troponina
ensayo inmunocromatografico	ensayo inmunocromatografico	PROCEDIMIENTO	ensayo inmunocromatografico
dexametasona	dexametasona	FARMACO	dexametasona
levetiracetam	levetiracetam	FARMACO	levetiracetam
maleato de clorfenamina	maleato de clorfenamina	FARMACO	maleato de clorfenamina
administro hidratacion	administro hidratacion	PROCEDIMIENTO	administro hidratacion
oseltamivir	oseltamivir	FARMACO	oseltamivir
exploracion clinica	exploracion clinica	PROCEDIMIENTO	exploracion clinica
neumonia intersticial bilateral	neumonia intersticial bilateral	ENFERMEDAD	neumonia intersticial bilateral
inapetencia	inapetencia	SINTOMA	inapetencia
virus de la inmunodeficiencia humana	virus de la inmunodeficiencia humana	SPECIES	virus de la inmunodeficiencia humana
trombolisis	trombolisis	PROCEDIMIENTO	trombolisis
paraplejia	paraplejia	ENFERMEDAD	paraplejia
insuficiencia mitral	insuficiencia mitral	ENFERMEDAD	insuficiencia mitral
enero de 2020	enero de 2020	FECHAS	enero de 2020
noviembre de 2011	noviembre de 2011	FECHAS	noviembre de 2011
PCT (proteinas)	PCT	PROTEINAS	PCT
sindrome de dificultad respiratoria aguda por coronavirus 2	sindrome de dificultad respiratoria aguda por coronavirus 2	ENFERMEDAD	sindrome de dificultad respiratoria aguda por coronavirus 2
dilatacion coronaria	dilatacion coronaria	ENFERMEDAD	dilatacion coronaria
indice de masa corporal	indice de masa corporal	ENTIDAD-OBSERVABLE	indice de masa corporal
sincope (sintoma)	sincope	SINTOMA	sincope
intubacion orotraqueal	intubacion orotraqueal	PROCEDIMIENTO	intubacion orotraqueal
ventilacion mecanica invasiva	ventilacion mecanica invasiva	PROCEDIMIENTO	ventilacion mecanica invasiva
RMN medular	RMN medular	PROCEDIMIENTO	RMN medular
arteriopatia periferica	arteriopatia periferica	ENFERMEDAD	arteriopatia periferica
erupcion farmacologica	erupcion farmacologica	ENFERMEDAD	erupcion farmacologica
conjuntivitis	conjuntivitis	ENFERMEDAD	conjuntivitis
hipertension idiopatica	hipertension idiopatica	ENFERMEDAD	hipertension idiopatica
nauseas	nauseas	SINTOMA	nauseas
O2	O2	FARMACO	O2
31 anos	31 anos	EDAD-SUJETO-ASISTENCIA	31 anos
bicarbonato sodico	bicarbonato sodico	FARMACO	bicarbonato sodico
antibioticos iv	antibioticos iv	PROCEDIMIENTO	antibioticos iv
8 anos	8 anos	EDAD-SUJETO-ASISTENCIA	8 anos
2015	2015	FECHAS	2015
PCR de frotis nasofaringeo	PCR de frotis nasofaringeo	PROCEDIMIENTO	PCR de frotis nasofaringeo
coagulacion intravascular generalizada	coagulacion intravascular generalizada	ENFERMEDAD	coagulacion intravascular generalizada
64 anos	64 anos	EDAD-SUJETO-ASISTENCIA	64 anos
cefepima	cefepima	FARMACO	cefepima
losartan	losartan	FARMACO	losartan
alteracion de la conciencia	alteracion de la conciencia	SINTOMA	alteracion de la conciencia
neuropatia desmielinizante	neuropatia desmielinizante	ENFERMEDAD	neuropatia desmielinizante
27 anos	27 anos	EDAD-SUJETO-ASISTENCIA	27 anos
salino	salino	FARMACO	salino
cribaje genetico	cribaje genetico	PROCEDIMIENTO	cribaje genetico
china	china	PAIS	china
bronquiectasia cistica	bronquiectasia cistica	ENFERMEDAD	bronquiectasia cistica
prueba de gripe	prueba de gripe	PROCEDIMIENTO	prueba de gripe
rehabilitacion	rehabilitacion	PROCEDIMIENTO	rehabilitacion
CRP	CRP	ENTIDAD-OBSERVABLE	CRP
36 anos	36 anos	EDAD-SUJETO-ASISTENCIA	36 anos
CD3	CD3	PROTEINAS	CD3
dolor de garganta	dolor de garganta	SINTOMA	dolor de garganta
animales	animales	SPECIES	animales
hiporexia	hiporexia	SINTOMA	hiporexia
mialgias	mialgias	SINTOMA	mialgias
aztreonam	aztreonam	FARMACO	aztreonam
lesiones cutaneas	lesiones cutaneas	ENFERMEDAD	lesiones cutaneas
solucion salina	solucion salina	FARMACO	solucion salina
bolos iv	bolos iv	PROCEDIMIENTO	bolos iv
administraron antiviricos	administraron antiviricos	PROCEDIMIENTO	administraron antiviricos
sangre edta	sangre edta	ENTIDAD-OBSERVABLE	sangre edta
2540l	2540l	PROTEINAS	2540l
saturacion de oxigeno en aire ambiental	saturacion de oxigeno en aire ambiental	SINTOMA	saturacion de oxigeno en aire ambiental
dimero D (farmaco)	dimero D	FARMACO	dimero D
ECG	ECG	PROCEDIMIENTO	ECG
hipovolemia	hipovolemia	ENFERMEDAD	hipovolemia
funcion renal	funcion renal	ENTIDAD-OBSERVABLE	funcion renal
temperatura axilar	temperatura axilar	ENTIDAD-OBSERVABLE	temperatura axilar
edema cerebral	edema cerebral	ENFERMEDAD	edema cerebral
mariposa	mariposa	SPECIES	mariposa
enfermedades cardiovasculares	enfermedades cardiovasculares	ENFERMEDAD	enfermedades cardiovasculares
evaluacion oftalmologica	evaluacion oftalmologica	PROCEDIMIENTO	evaluacion oftalmologica
hipotermia	hipotermia	SINTOMA	hipotermia
moxifloxacino (farmaco)	moxifloxacino	FARMACO	moxifloxacino
marcadores sericos	marcadores sericos	ENTIDAD-OBSERVABLE	marcadores sericos
creatinacinasa (entidad-observable)	creatinacinasa	ENTIDAD-OBSERVABLE	creatinacinasa
epinefrina	epinefrina	FARMACO	epinefrina
1 de febrero de 2020	1 de febrero de 2020	FECHAS	1 de febrero de 2020
disminucion bilateral de los ruidos respiratorios	disminucion bilateral de los ruidos respiratorios	SINTOMA	disminucion bilateral de los ruidos respiratorios
inflamacion glotica significativa y abundante secrecion de las vias respiratorias	inflamacion glotica significativa y abundante secrecion de las vias respiratorias	SINTOMA	inflamacion glotica significativa y abundante secrecion de las vias respiratorias
proteinorraquia (entidad-observable)	proteinorraquia	ENTIDAD-OBSERVABLE	proteinorraquia
anticuerpos contra citomegalovirus	anticuerpos contra citomegalovirus	ENTIDAD-OBSERVABLE	anticuerpos contra citomegalovirus
ventilacion protectora	ventilacion protectora	PROCEDIMIENTO	ventilacion protectora
57 anos	57 anos	EDAD-SUJETO-ASISTENCIA	57 anos
pruebas serologicas de IgG de sarscov2	pruebas serologicas de IgG de sarscov2	PROCEDIMIENTO	pruebas serologicas de IgG de sarscov2
RMN cerebrales	RMN cerebrales	PROCEDIMIENTO	RMN cerebrales
C koseri	C koseri	SPECIES	C koseri
12 de marzo	12 de marzo	FECHAS	12 de marzo
4 de febrero de 2020	4 de febrero de 2020	FECHAS	4 de febrero de 2020
deshidrogenasa lactica (proteinas)	deshidrogenasa lactica	PROTEINAS	deshidrogenasa lactica
SNC	SNC	ENFERMEDAD	SNC
antiviricos y corticosteroides	antiviricos y corticosteroides	PROCEDIMIENTO	antiviricos y corticosteroides
desorientacion	desorientacion	SINTOMA	desorientacion
proteina creactiva262	proteina creactiva262	PROTEINAS	proteina creactiva262
oliguria	oliguria	SINTOMA	oliguria
42 anos	42 anos	EDAD-SUJETO-ASISTENCIA	42 anos
bacterias	bacterias	SPECIES	bacterias
ecografia abdominal	ecografia abdominal	PROCEDIMIENTO	ecografia abdominal
TAC cerebral	TAC cerebral	PROCEDIMIENTO	TAC cerebral
alaninaaminotransferasa (proteinas)	alaninaaminotransferasa	PROTEINAS	alaninaaminotransferasa
7 anos	7 anos	EDAD-SUJETO-ASISTENCIA	7 anos
venlafaxina	venlafaxina	FARMACO	venlafaxina
neumonia bilateral grave	neumonia bilateral grave	ENFERMEDAD	neumonia bilateral grave
malestar	malestar	SINTOMA	malestar
esplenomegalia a la palpacion	esplenomegalia a la palpacion	SINTOMA	esplenomegalia a la palpacion
VIH	VIH	SPECIES	VIH
mujer	mujer	SEXO-SUJETO-ASISTENCIA	mujer
cultivos de LCR	cultivos de LCR	PROCEDIMIENTO	cultivos de LCR
16 anos	16 anos	EDAD-SUJETO-ASISTENCIA	16 anos
44 anos	44 anos	EDAD-SUJETO-ASISTENCIA	44 anos
anticuerpos anticitoplasmicos de neutrofilos (entidad-observable)	anticuerpos anticitoplasmicos de neutrofilos	ENTIDAD-OBSERVABLE	anticuerpos anticitoplasmicos de neutrofilos
frecuencia cardiaca	frecuencia cardiaca	ENTIDAD-OBSERVABLE	frecuencia cardiaca
frotis orofaringeo	frotis orofaringeo	PROCEDIMIENTO	frotis orofaringeo
anemia normocitica	anemia normocitica	ENFERMEDAD	anemia normocitica
trombofilia	trombofilia	ENFERMEDAD	trombofilia
aumento de la creatinacinasa	aumento de la creatinacinasa	SINTOMA	aumento de la creatinacinasa
urea	urea	FARMACO	urea
2 de febrero de 2020	2 de febrero de 2020	FECHAS	2 de febrero de 2020
20 de enero	20 de enero	FECHAS	20 de enero
28 de febrero	28 de febrero	FECHAS	28 de febrero
peptido natriuretico	peptido natriuretico	ENTIDAD-OBSERVABLE	peptido natriuretico
S pneumoniae	S pneumoniae	SPECIES	S pneumoniae
ixekizumab	ixekizumab	FARMACO	ixekizumab
ansiedad (enfermedad)	ansiedad	ENFERMEDAD	ansiedad
antigeno de galactomanano	antigeno de galactomanano	PROTEINAS	antigeno de galactomanano
linfocitopenia (proteinas)	linfocitopenia	PROTEINAS	linfocitopenia
del Sur	del Sur	TERRITORIO	del Sur
neutrofilia	neutrofilia	SINTOMA	neutrofilia
anticoagulante por via oral	anticoagulante por via oral	PROCEDIMIENTO	anticoagulante por via oral
hiperfibrinogenemia	hiperfibrinogenemia	ENFERMEDAD	hiperfibrinogenemia
62 anos	62 anos	EDAD-SUJETO-ASISTENCIA	62 anos
bergamo	bergamo	TERRITORIO	bergamo
buen apetito	buen apetito	SINTOMA	buen apetito
13 de marzo	13 de marzo	FECHAS	13 de marzo
preeclampsia	preeclampsia	ENFERMEDAD	preeclampsia
delirio extravagante	delirio extravagante	ENFERMEDAD	delirio extravagante
biopsia cutanea	biopsia cutanea	PROCEDIMIENTO	biopsia cutanea
analisis del LCR	analisis del LCR	PROCEDIMIENTO	analisis del LCR
metotrexato	metotrexato	FARMACO	metotrexato
2 de abril de 2020	2 de abril de 2020	FECHAS	2 de abril de 2020
exantema persistente	exantema persistente	SINTOMA	exantema persistente
falta de realce de parte del intestino delgado	falta de realce de parte del intestino delgado	SINTOMA	falta de realce de parte del intestino delgado
somnolencia	somnolencia	SINTOMA	somnolencia
anosmia aguda	anosmia aguda	ENFERMEDAD	anosmia aguda
acido clavulanico	acido clavulanico	FARMACO	acido clavulanico
14 de marzo	14 de marzo	FECHAS	14 de marzo
FC	FC	ENTIDAD-OBSERVABLE	FC
ofloxacina	ofloxacina	FARMACO	ofloxacina
darunavir	darunavir	FARMACO	darunavir
intervencion coronaria percutanea	intervencion coronaria percutanea	PROCEDIMIENTO	intervencion coronaria percutanea
congestion	congestion	SINTOMA	congestion
derrame pericardico	derrame pericardico	ENFERMEDAD	derrame pericardico
encefalitis	encefalitis	ENFERMEDAD	encefalitis
petequias eritematosas que afectaban a las nalgas las fosas popliteas y la parte anterior de los muslos	petequias eritematosas que afectaban a las nalgas las fosas popliteas y la parte anterior de los muslos	SINTOMA	petequias eritematosas que afectaban a las nalgas las fosas popliteas y la parte anterior de los muslos
anomalias de las extremidades superiores (enfermedad)	anomalias de las extremidades superiores	ENFERMEDAD	anomalias de las extremidades superiores
deficit de atencion (enfermedad)	deficit de atencion	ENFERMEDAD	deficit de atencion
TAC	TAC	PROCEDIMIENTO	TAC
deshidratacion moderada	deshidratacion moderada	ENFERMEDAD	deshidratacion moderada
vinc	vinc	ENFERMEDAD	vinc
colitis ulcerosa	colitis ulcerosa	ENFERMEDAD	colitis ulcerosa
hipertension arterial sistemica	hipertension arterial sistemica	ENFERMEDAD	hipertension arterial sistemica
tratamiento combinado de antirretrovirales	tratamiento combinado de antirretrovirales	PROCEDIMIENTO	tratamiento combinado de antirretrovirales
volumen globular	volumen globular	ENTIDAD-OBSERVABLE	volumen globular
actividad renal	actividad renal	ENTIDAD-OBSERVABLE	actividad renal
debilidad distal en las extremidades superiores	debilidad distal en las extremidades superiores	SINTOMA	debilidad distal en las extremidades superiores
reduccion de la ingesta oral	reduccion de la ingesta oral	SINTOMA	reduccion de la ingesta oral
aumento de LDH	aumento de LDH	SINTOMA	aumento de LDH
AAS	AAS	FARMACO	AAS
omeprazol	omeprazol	FARMACO	omeprazol
epileptico no convulsivo	epileptico no convulsivo	ENFERMEDAD	epileptico no convulsivo
sobreinfecciones bacterianas	sobreinfecciones bacterianas	ENFERMEDAD	sobreinfecciones bacterianas
desmayo	desmayo	SINTOMA	desmayo
gasometria arterial (procedimiento)	gasometria arterial	PROCEDIMIENTO	gasometria arterial
interferon gamma (farmaco)	interferon gamma	FARMACO	interferon gamma
covid19 (enfermedad)	covid19	ENFERMEDAD	covid19
evaluacion neurologica	evaluacion neurologica	PROCEDIMIENTO	evaluacion neurologica
plasmaferesis	plasmaferesis	PROCEDIMIENTO	plasmaferesis
pruebas serologicas de hepatitis virica	pruebas serologicas de hepatitis virica	PROCEDIMIENTO	pruebas serologicas de hepatitis virica
frotis nasofaringeoorofaringeos	frotis nasofaringeoorofaringeos	PROCEDIMIENTO	frotis nasofaringeoorofaringeos
glucemia	glucemia	ENTIDAD-OBSERVABLE	glucemia
tratamiento antibiotico	tratamiento antibiotico	PROCEDIMIENTO	tratamiento antibiotico
tratamiento anticoagulante	tratamiento anticoagulante	PROCEDIMIENTO	tratamiento anticoagulante
abombamiento apical	abombamiento apical	SINTOMA	abombamiento apical
afeccion aguda	afeccion aguda	ENFERMEDAD	afeccion aguda
CPK (proteinas)	CPK	PROTEINAS	CPK
M tuberculosis	M tuberculosis	SPECIES	M tuberculosis
aumento de la cifra de trombocitos	aumento de la cifra de trombocitos	SINTOMA	aumento de la cifra de trombocitos
alteracion de la marcha	alteracion de la marcha	SINTOMA	alteracion de la marcha
marcadores inflamatorios	marcadores inflamatorios	ENTIDAD-OBSERVABLE	marcadores inflamatorios
de aspergillus	de aspergillus	SPECIES	de aspergillus
afasia anomica (sintoma)	afasia anomica	SINTOMA	afasia anomica
ADA	ADA	PROTEINAS	ADA
cesarea	cesarea	PROCEDIMIENTO	cesarea
fumadora	fumadora	ENFERMEDAD	fumadora
16 de febrero	16 de febrero	FECHAS	16 de febrero
ablacion cardiaca triple	ablacion cardiaca triple	PROCEDIMIENTO	ablacion cardiaca triple
anosmia completa	anosmia completa	ENFERMEDAD	anosmia completa
administracion de colquicina	administracion de colquicina	PROCEDIMIENTO	administracion de colquicina
vasopresores	vasopresores	PROCEDIMIENTO	vasopresores
emtricitabine	emtricitabine	FARMACO	emtricitabine
ibuprofeno	ibuprofeno	FARMACO	ibuprofeno
estenosis focal moderada de la ACM	estenosis focal moderada de la ACM	ENFERMEDAD	estenosis focal moderada de la ACM
43 anos	43 anos	EDAD-SUJETO-ASISTENCIA	43 anos
soluble	soluble	FARMACO	soluble
ciclesonida	ciclesonida	FARMACO	ciclesonida
empeoramiento del estado respiratorio	empeoramiento del estado respiratorio	SINTOMA	empeoramiento del estado respiratorio
debilidad	debilidad	SINTOMA	debilidad
acinetobacter	acinetobacter	SPECIES	acinetobacter
infarto pulmonar triangular periferico	infarto pulmonar triangular periferico	ENFERMEDAD	infarto pulmonar triangular periferico
actividad sistolica	actividad sistolica	ENTIDAD-OBSERVABLE	actividad sistolica
bacteroides ovalus	bacteroides ovalus	SPECIES	bacteroides ovalus
macrohematuria (sintoma)	macrohematuria	SINTOMA	macrohematuria
bolonia	bolonia	TERRITORIO	bolonia
apiretico	apiretico	SINTOMA	apiretico
deterioro de la actividad renal	deterioro de la actividad renal	SINTOMA	deterioro de la actividad renal
PCR de sangre y LCR	PCR de sangre y LCR	PROCEDIMIENTO	PCR de sangre y LCR
67 anos	67 anos	EDAD-SUJETO-ASISTENCIA	67 anos
ecocardiograma	ecocardiograma	PROCEDIMIENTO	ecocardiograma
alaninoaminotransferasa (entidad-observable)	alaninoaminotransferasa	ENTIDAD-OBSERVABLE	alaninoaminotransferasa
anticuerpos citoplasmaticos antineutrofilicos	anticuerpos citoplasmaticos antineutrofilicos	PROTEINAS	anticuerpos citoplasmaticos antineutrofilicos
radiocinematografia	radiocinematografia	PROCEDIMIENTO	radiocinematografia
signos respiratorios	signos respiratorios	SINTOMA	signos respiratorios
fiebre	fiebre	SINTOMA	fiebre
arbidol	arbidol	FARMACO	arbidol
cociente ttpa	cociente ttpa	ENTIDAD-OBSERVABLE	cociente ttpa
babinski	babinski	PROTEINAS	babinski
bradicardia irreversibles	bradicardia irreversibles	ENFERMEDAD	bradicardia irreversibles
sudoracion	sudoracion	SINTOMA	sudoracion
C4	C4	PROTEINAS	C4
radioterapia	radioterapia	PROCEDIMIENTO	radioterapia
humano	humano	SPECIES	humano
tratamiento con inhalador de ciclesonida	tratamiento con inhalador de ciclesonida	PROCEDIMIENTO	tratamiento con inhalador de ciclesonida
TVP	TVP	ENFERMEDAD	TVP
aumento de proteina creactiva	aumento de proteina creactiva	SINTOMA	aumento de proteina creactiva
aumento adicional de la proteina creactiva	aumento adicional de la proteina creactiva	SINTOMA	aumento adicional de la proteina creactiva
wuhan	wuhan	TERRITORIO	wuhan
desorientado	desorientado	SINTOMA	desorientado
71 anos	71 anos	EDAD-SUJETO-ASISTENCIA	71 anos
artritis	artritis	ENFERMEDAD	artritis
covid19 grave	covid19 grave	ENFERMEDAD	covid19 grave
transfusion de plasma	transfusion de plasma	PROCEDIMIENTO	transfusion de plasma
LDH (entidad-observable)	LDH	ENTIDAD-OBSERVABLE	LDH
29 de marzo	29 de marzo	FECHAS	29 de marzo
23 de mayo	23 de mayo	FECHAS	23 de mayo
alteracion grave de las cavidades cardiacas	alteracion grave de las cavidades cardiacas	SINTOMA	alteracion grave de las cavidades cardiacas
terapia antivirica	terapia antivirica	PROCEDIMIENTO	terapia antivirica
respiracion asistida	respiracion asistida	PROCEDIMIENTO	respiracion asistida
soporte inotropico	soporte inotropico	PROCEDIMIENTO	soporte inotropico
gabapentina	gabapentina	FARMACO	gabapentina
anticuerpos IgM e IgG	anticuerpos IgM e IgG	ENTIDAD-OBSERVABLE	anticuerpos IgM e IgG
intoxicacion por litio	intoxicacion por litio	ENFERMEDAD	intoxicacion por litio
hemoptisis	hemoptisis	ENFERMEDAD	hemoptisis
19 de abril de 2020	19 de abril de 2020	FECHAS	19 de abril de 2020
coma arreactivo	coma arreactivo	ENFERMEDAD	coma arreactivo
disminucion de la ingesta oral	disminucion de la ingesta oral	SINTOMA	disminucion de la ingesta oral
hiperglucemia (enfermedad)	hiperglucemia	ENFERMEDAD	hiperglucemia
ecografia a pie de cama	ecografia a pie de cama	PROCEDIMIENTO	ecografia a pie de cama
pantoprazol	pantoprazol	FARMACO	pantoprazol
sulfato de hidroxicloroquina	sulfato de hidroxicloroquina	FARMACO	sulfato de hidroxicloroquina
alemania (proteinas)	alemania	PROTEINAS	alemania
embolias pulmonares segmentarias	embolias pulmonares segmentarias	ENFERMEDAD	embolias pulmonares segmentarias
convulsiones	convulsiones	SINTOMA	convulsiones
deterioro hemodinamico	deterioro hemodinamico	SINTOMA	deterioro hemodinamico
fentanilo	fentanilo	FARMACO	fentanilo
exploracion respiratoria	exploracion respiratoria	PROCEDIMIENTO	exploracion respiratoria
de tormenta de citocinas	de tormenta de citocinas	ENFERMEDAD	de tormenta de citocinas
aspiracion de canula orotraqueal	aspiracion de canula orotraqueal	PROCEDIMIENTO	aspiracion de canula orotraqueal
del enfermo eutiroideo	del enfermo eutiroideo	ENFERMEDAD	del enfermo eutiroideo
VSG	VSG	ENTIDAD-OBSERVABLE	VSG
anticuerpos anticitoplasmaticos de neutrofilos (entidad-observable)	anticuerpos anticitoplasmaticos de neutrofilos	ENTIDAD-OBSERVABLE	anticuerpos anticitoplasmaticos de neutrofilos
biopsia de piel	biopsia de piel	PROCEDIMIENTO	biopsia de piel
restriccion hidrica	restriccion hidrica	PROCEDIMIENTO	restriccion hidrica
colquicina	colquicina	FARMACO	colquicina
il1 recombinante	il1 recombinante	FARMACO	il1 recombinante
70 anos	70 anos	EDAD-SUJETO-ASISTENCIA	70 anos
deshidrogenasa	deshidrogenasa	PROTEINAS	deshidrogenasa
frotis nasofaringeo en las fosas nasales	frotis nasofaringeo en las fosas nasales	PROCEDIMIENTO	frotis nasofaringeo en las fosas nasales
fasciotomias en ambos brazos y ambas piernas	fasciotomias en ambos brazos y ambas piernas	PROCEDIMIENTO	fasciotomias en ambos brazos y ambas piernas
tratamiento local con corticosteroides	tratamiento local con corticosteroides	PROCEDIMIENTO	tratamiento local con corticosteroides
prueba para anticoagulante lupico	prueba para anticoagulante lupico	PROCEDIMIENTO	prueba para anticoagulante lupico
dolor abdominal en el area epigastrica	dolor abdominal en el area epigastrica	SINTOMA	dolor abdominal en el area epigastrica
49 anos	49 anos	EDAD-SUJETO-ASISTENCIA	49 anos
insectos	insectos	SPECIES	insectos
reanimacion cardiopulmonar	reanimacion cardiopulmonar	PROCEDIMIENTO	reanimacion cardiopulmonar
sindrome respiratorio agudo grave	sindrome respiratorio agudo grave	ENFERMEDAD	sindrome respiratorio agudo grave
disminucion de la velocidad de conduccion motora peroneal	disminucion de la velocidad de conduccion motora peroneal	SINTOMA	disminucion de la velocidad de conduccion motora peroneal
aumento de la cifra de eritrocitos	aumento de la cifra de eritrocitos	SINTOMA	aumento de la cifra de eritrocitos
expectoracion hemoptoica	expectoracion hemoptoica	SINTOMA	expectoracion hemoptoica
31 de marzo	31 de marzo	FECHAS	31 de marzo
suero	suero	FARMACO	suero
arteriopatia coronaria obstructiva	arteriopatia coronaria obstructiva	ENFERMEDAD	arteriopatia coronaria obstructiva
expectoracion	expectoracion	SINTOMA	expectoracion
82 anos	82 anos	EDAD-SUJETO-ASISTENCIA	82 anos
C1q	C1q	PROTEINAS	C1q
26 de marzo	26 de marzo	FECHAS	26 de marzo
analisis serologico de aspergillus y antigenemia	analisis serologico de aspergillus y antigenemia	PROCEDIMIENTO	analisis serologico de aspergillus y antigenemia
encefalitis inmunitaria	encefalitis inmunitaria	ENFERMEDAD	encefalitis inmunitaria
lesiones pulmonares	lesiones pulmonares	ENFERMEDAD	lesiones pulmonares
azitromicina	azitromicina	FARMACO	azitromicina
neumonia intersticial	neumonia intersticial	ENFERMEDAD	neumonia intersticial
aumento de leucocitosis	aumento de leucocitosis	SINTOMA	aumento de leucocitosis
betametasona	betametasona	FARMACO	betametasona
cincuenta anos	cincuenta anos	EDAD-SUJETO-ASISTENCIA	cincuenta anos
trombosis venosa	trombosis venosa	ENFERMEDAD	trombosis venosa
neumonia extrahospitalaria	neumonia extrahospitalaria	ENFERMEDAD	neumonia extrahospitalaria
14 de febrero	14 de febrero	FECHAS	14 de febrero
albumina (farmaco)	albumina	FARMACO	albumina
parto vaginal (procedimiento)	parto vaginal	PROCEDIMIENTO	parto vaginal
normalizacion de la proteina creactiva	normalizacion de la proteina creactiva	SINTOMA	normalizacion de la proteina creactiva
infecciosas de livedo	infecciosas de livedo	ENFERMEDAD	infecciosas de livedo
estreptococo	estreptococo	SPECIES	estreptococo
74 anos	74 anos	EDAD-SUJETO-ASISTENCIA	74 anos
potasio	potasio	FARMACO	potasio
analisis bioquimico serico	analisis bioquimico serico	PROCEDIMIENTO	analisis bioquimico serico
exantema	exantema	SINTOMA	exantema
anticoagulacion con heparina	anticoagulacion con heparina	PROCEDIMIENTO	anticoagulacion con heparina
4 de febrero	4 de febrero	FECHAS	4 de febrero
cianosis	cianosis	SINTOMA	cianosis
covid19 (id-sujeto-asistencia)	covid19	ID-SUJETO-ASISTENCIA	covid19
TAC cardiaca	TAC cardiaca	PROCEDIMIENTO	TAC cardiaca
anticuerpos antigangliosidos sericos	anticuerpos antigangliosidos sericos	ENTIDAD-OBSERVABLE	anticuerpos antigangliosidos sericos
15 de abril de 2020	15 de abril de 2020	FECHAS	15 de abril de 2020
coronavirus nl63	coronavirus nl63	SPECIES	coronavirus nl63
administracion de noradrenalina	administracion de noradrenalina	PROCEDIMIENTO	administracion de noradrenalina
arreflexia en ambas piernas y pies	arreflexia en ambas piernas y pies	SINTOMA	arreflexia en ambas piernas y pies
28 anos	28 anos	EDAD-SUJETO-ASISTENCIA	28 anos
24 de febrero	24 de febrero	FECHAS	24 de febrero
profilaxis antitrombotica	profilaxis antitrombotica	PROCEDIMIENTO	profilaxis antitrombotica
japon	japon	PAIS	japon
anticuerpos viricos (proteinas)	anticuerpos viricos	PROTEINAS	anticuerpos viricos
abrasion del labio inferior (sintoma)	abrasion del labio inferior	SINTOMA	abrasion del labio inferior
CT (proteinas)	CT	PROTEINAS	CT
control antiinfecciosas	control antiinfecciosas	PROCEDIMIENTO	control antiinfecciosas
ventilacion no invasiva	ventilacion no invasiva	PROCEDIMIENTO	ventilacion no invasiva
eructos	eructos	SINTOMA	eructos
carbonato calcico	carbonato calcico	FARMACO	carbonato calcico
BC	BC	PROTEINAS	BC
biopsia broncoscopica	biopsia broncoscopica	PROCEDIMIENTO	biopsia broncoscopica
aumento de los crepitantes pulmonares	aumento de los crepitantes pulmonares	SINTOMA	aumento de los crepitantes pulmonares
roncus	roncus	SINTOMA	roncus
27 de abril	27 de abril	FECHAS	27 de abril
11 de mayo	11 de mayo	FECHAS	11 de mayo
dolor a la palpacion en la pared toracica	dolor a la palpacion en la pared toracica	SINTOMA	dolor a la palpacion en la pared toracica
dolor pleural	dolor pleural	SINTOMA	dolor pleural
EE	EE	PAIS	EE
ateroesclerosis aortica	ateroesclerosis aortica	ENFERMEDAD	ateroesclerosis aortica
TCA superior	TCA superior	ENFERMEDAD	TCA superior
aspartatotransaminasa (proteinas)	aspartatotransaminasa	PROTEINAS	aspartatotransaminasa
sincope (enfermedad)	sincope	ENFERMEDAD	sincope
bilirrubina	bilirrubina	FARMACO	bilirrubina
cobicistat	cobicistat	FARMACO	cobicistat
proteina	proteina	PROTEINAS	proteina
anomalia en el tabique auricular	anomalia en el tabique auricular	ENFERMEDAD	anomalia en el tabique auricular
neumonia bilateral	neumonia bilateral	ENFERMEDAD	neumonia bilateral
crisis	crisis	ENFERMEDAD	crisis
Kit	Kit	PROTEINAS	Kit
angustia	angustia	SINTOMA	angustia
aumento de leucocitos y proteinas	aumento de leucocitos y proteinas	SINTOMA	aumento de leucocitos y proteinas
lactatodeshidrogenasa (proteinas)	lactatodeshidrogenasa	PROTEINAS	lactatodeshidrogenasa
infecciones	infecciones	ENFERMEDAD	infecciones
infeccion virica de las vias respiratorias altas	infeccion virica de las vias respiratorias altas	ENFERMEDAD	infeccion virica de las vias respiratorias altas
prednisolona	prednisolona	FARMACO	prednisolona
meticilina	meticilina	FARMACO	meticilina
ramipril	ramipril	FARMACO	ramipril
proteinorraquia (proteinas)	proteinorraquia	PROTEINAS	proteinorraquia
embolia pulmonar	embolia pulmonar	ENFERMEDAD	embolia pulmonar
ecocardiografia	ecocardiografia	PROCEDIMIENTO	ecocardiografia
EEG	EEG	PROCEDIMIENTO	EEG
lubeck	lubeck	TERRITORIO	lubeck
IgM	IgM	PROTEINAS	IgM
Na	Na	FARMACO	Na
klebsiella pneumoniae	klebsiella pneumoniae	SPECIES	klebsiella pneumoniae
acidosis lactica	acidosis lactica	ENFERMEDAD	acidosis lactica
rtpcr de frotis nasofaringeo	rtpcr de frotis nasofaringeo	PROCEDIMIENTO	rtpcr de frotis nasofaringeo
alteracion en la sensibilidad de los 4 miembros a nivel distal	alteracion en la sensibilidad de los 4 miembros a nivel distal	SINTOMA	alteracion en la sensibilidad de los 4 miembros a nivel distal
lesion miocardica	lesion miocardica	ENFERMEDAD	lesion miocardica
manitol	manitol	FARMACO	manitol
consolidacion anular en el lobulo superior	consolidacion anular en el lobulo superior	ENFERMEDAD	consolidacion anular en el lobulo superior
derrame pleural bilateral	derrame pleural bilateral	ENFERMEDAD	derrame pleural bilateral
farmacos inmunosupresores	farmacos inmunosupresores	PROCEDIMIENTO	farmacos inmunosupresores
trasplante renal	trasplante renal	PROCEDIMIENTO	trasplante renal
fusarium proliferatum	fusarium proliferatum	SPECIES	fusarium proliferatum
agudeza visual	agudeza visual	ENTIDAD-OBSERVABLE	agudeza visual
legionella	legionella	SPECIES	legionella
ARM	ARM	PROCEDIMIENTO	ARM
dolor en su pierna	dolor en su pierna	SINTOMA	dolor en su pierna
administracion de tensioactivos	administracion de tensioactivos	PROCEDIMIENTO	administracion de tensioactivos
PCR de otros virus respiratorios	PCR de otros virus respiratorios	PROCEDIMIENTO	PCR de otros virus respiratorios
afecciones respiratorias	afecciones respiratorias	ENFERMEDAD	afecciones respiratorias
nefropatia por IgA	nefropatia por IgA	ENFERMEDAD	nefropatia por IgA
hemiplegia faciobraquiofemoral	hemiplegia faciobraquiofemoral	ENFERMEDAD	hemiplegia faciobraquiofemoral
troponinai (entidad-observable)	troponinai	ENTIDAD-OBSERVABLE	troponinai
2017	2017	FECHAS	2017
prohormona nterminal del peptido	prohormona nterminal del peptido	PROTEINAS	prohormona nterminal del peptido
anticuerpos viricos (entidad-observable)	anticuerpos viricos	ENTIDAD-OBSERVABLE	anticuerpos viricos
anomalias de las extremidades superiores (sintoma)	anomalias de las extremidades superiores	SINTOMA	anomalias de las extremidades superiores
abril	abril	FECHAS	abril
9	9	FECHAS	9
FA (entidad-observable)	FA	ENTIDAD-OBSERVABLE	FA
deshidratacion	deshidratacion	ENFERMEDAD	deshidratacion
choque	choque	SINTOMA	choque
consolidacion en diferentes regiones de todo el pulmon	consolidacion en diferentes regiones de todo el pulmon	ENFERMEDAD	consolidacion en diferentes regiones de todo el pulmon
gangrena	gangrena	ENFERMEDAD	gangrena
PCR (proteinas)	PCR	PROTEINAS	PCR
lombardia	lombardia	TERRITORIO	lombardia
biopsia en sacabocados de 5 mm de la nalga izquierda	biopsia en sacabocados de 5 mm de la nalga izquierda	PROCEDIMIENTO	biopsia en sacabocados de 5 mm de la nalga izquierda
indice ROX	indice ROX	ENTIDAD-OBSERVABLE	indice ROX
condensacion pulmonar	condensacion pulmonar	ENFERMEDAD	condensacion pulmonar
TAC toracica de corte fino	TAC toracica de corte fino	PROCEDIMIENTO	TAC toracica de corte fino
tromboemboloectomia	tromboemboloectomia	PROCEDIMIENTO	tromboemboloectomia
ictus isquemico	ictus isquemico	ENFERMEDAD	ictus isquemico
TAC abdominal y pelvica	TAC abdominal y pelvica	PROCEDIMIENTO	TAC abdominal y pelvica
heparina de bajo peso molecular	heparina de bajo peso molecular	FARMACO	heparina de bajo peso molecular
RMN craneal	RMN craneal	PROCEDIMIENTO	RMN craneal
procalcitonina (proteinas)	procalcitonina	PROTEINAS	procalcitonina
teicoplanina	teicoplanina	FARMACO	teicoplanina
indice de apgar	indice de apgar	ENTIDAD-OBSERVABLE	indice de apgar
mycoplasma pneumoniae	mycoplasma pneumoniae	SPECIES	mycoplasma pneumoniae
puncion lumbar	puncion lumbar	PROCEDIMIENTO	puncion lumbar
pruebas de esputo	pruebas de esputo	PROCEDIMIENTO	pruebas de esputo
lesiones miocardicas	lesiones miocardicas	ENFERMEDAD	lesiones miocardicas
aspirado traqueal	aspirado traqueal	PROCEDIMIENTO	aspirado traqueal
cov2	cov2	FARMACO	cov2
debilidad muscular	debilidad muscular	SINTOMA	debilidad muscular
crepitantes bilaterales en ambos pulmones	crepitantes bilaterales en ambos pulmones	SINTOMA	crepitantes bilaterales en ambos pulmones
moxifloxacino (proteinas)	moxifloxacino	PROTEINAS	moxifloxacino
GPT (entidad-observable)	GPT	ENTIDAD-OBSERVABLE	GPT
polonia	polonia	PAIS	polonia
dilatacion del ventriculo	dilatacion del ventriculo	ENFERMEDAD	dilatacion del ventriculo
angiografia coronaria	angiografia coronaria	PROCEDIMIENTO	angiografia coronaria
79 anos	79 anos	EDAD-SUJETO-ASISTENCIA	79 anos
20 anos	20 anos	EDAD-SUJETO-ASISTENCIA	20 anos
cardiotocografia	cardiotocografia	PROCEDIMIENTO	cardiotocografia
elevacion difusa del segmento ST	elevacion difusa del segmento ST	SINTOMA	elevacion difusa del segmento ST
disfuncion respiratoria (enfermedad)	disfuncion respiratoria	ENFERMEDAD	disfuncion respiratoria
ENA	ENA	PROTEINAS	ENA
exploracion pulmonar	exploracion pulmonar	PROCEDIMIENTO	exploracion pulmonar
retraccion subcostal	retraccion subcostal	SINTOMA	retraccion subcostal
meropenem	meropenem	FARMACO	meropenem
ganciclovir	ganciclovir	FARMACO	ganciclovir
cefotaxima	cefotaxima	FARMACO	cefotaxima
anticuerpos antigangliosidos (proteinas)	anticuerpos antigangliosidos	PROTEINAS	anticuerpos antigangliosidos
bebedora (sintoma)	bebedora	SINTOMA	bebedora
18 de abril	18 de abril	FECHAS	18 de abril
diabetes mellitus tipo 2	diabetes mellitus tipo 2	ENFERMEDAD	diabetes mellitus tipo 2
sodio	sodio	FARMACO	sodio
staphylococcus aureus	staphylococcus aureus	SPECIES	staphylococcus aureus
TAC craneal sin contraste	TAC craneal sin contraste	PROCEDIMIENTO	TAC craneal sin contraste
tratamiento antiinflamatorio	tratamiento antiinflamatorio	PROCEDIMIENTO	tratamiento antiinflamatorio
sobreinfecciones	sobreinfecciones	ENFERMEDAD	sobreinfecciones
infeccion por 2019ncov	infeccion por 2019ncov	ENFERMEDAD	infeccion por 2019ncov
urticaria (enfermedad)	urticaria	ENFERMEDAD	urticaria
velocidad de sedimentacion globular	velocidad de sedimentacion globular	ENTIDAD-OBSERVABLE	velocidad de sedimentacion globular
anticuerpos antigangliosidos (entidad-observable)	anticuerpos antigangliosidos	ENTIDAD-OBSERVABLE	anticuerpos antigangliosidos
presion parcial arterial	presion parcial arterial	ENTIDAD-OBSERVABLE	presion parcial arterial
frotis orofaringeos	frotis orofaringeos	PROCEDIMIENTO	frotis orofaringeos
hemodialisis	hemodialisis	PROCEDIMIENTO	hemodialisis
linfocitopenia (enfermedad)	linfocitopenia	ENFERMEDAD	linfocitopenia
cultivos viricos en celulas vero	cultivos viricos en celulas vero	PROCEDIMIENTO	cultivos viricos en celulas vero
claustrofobia	claustrofobia	ENFERMEDAD	claustrofobia
arteriopatia coronaria trivascular	arteriopatia coronaria trivascular	ENFERMEDAD	arteriopatia coronaria trivascular
virico	virico	SPECIES	virico
extubacion paliativa	extubacion paliativa	PROCEDIMIENTO	extubacion paliativa
alteracion de la capacidad hepatica y renal	alteracion de la capacidad hepatica y renal	SINTOMA	alteracion de la capacidad hepatica y renal
hemorragias (sintoma)	hemorragias	SINTOMA	hemorragias
linfoma de celulas del manto	linfoma de celulas del manto	ENFERMEDAD	linfoma de celulas del manto
enfermedades infecciosas	enfermedades infecciosas	ENFERMEDAD	enfermedades infecciosas
aspartatotransaminasa (entidad-observable)	aspartatotransaminasa	ENTIDAD-OBSERVABLE	aspartatotransaminasa
alteraciones cutaneas	alteraciones cutaneas	SINTOMA	alteraciones cutaneas
RMN craneal con contraste	RMN craneal con contraste	PROCEDIMIENTO	RMN craneal con contraste
sobreinfeccion	sobreinfeccion	ENFERMEDAD	sobreinfeccion
hiperplasia prostatica benigna	hiperplasia prostatica benigna	ENFERMEDAD	hiperplasia prostatica benigna
PCR de esputo	PCR de esputo	PROCEDIMIENTO	PCR de esputo
RMN cerebral y de los huesos temporales	RMN cerebral y de los huesos temporales	PROCEDIMIENTO	RMN cerebral y de los huesos temporales
58 anos	58 anos	EDAD-SUJETO-ASISTENCIA	58 anos
apirexia	apirexia	SINTOMA	apirexia
oxigenacion por membrana extracorporal	oxigenacion por membrana extracorporal	PROCEDIMIENTO	oxigenacion por membrana extracorporal
treponema pallidum	treponema pallidum	SPECIES	treponema pallidum
clozapina	clozapina	FARMACO	clozapina
parestesia izquierda y paresia ipsilateral	parestesia izquierda y paresia ipsilateral	SINTOMA	parestesia izquierda y paresia ipsilateral
incapacidad de andar	incapacidad de andar	SINTOMA	incapacidad de andar
troponina I (proteinas)	troponina I	PROTEINAS	troponina I
aptc	aptc	PROCEDIMIENTO	aptc
radiografia toracica	radiografia toracica	PROCEDIMIENTO	radiografia toracica
anticuerpos anticardiolipinicos	anticuerpos anticardiolipinicos	PROTEINAS	anticuerpos anticardiolipinicos
miopericarditis	miopericarditis	ENFERMEDAD	miopericarditis
poliuria	poliuria	SINTOMA	poliuria
hipertrofia biventricular	hipertrofia biventricular	ENFERMEDAD	hipertrofia biventricular
consolidacion multifocal en ambos campos pulmonares	consolidacion multifocal en ambos campos pulmonares	ENFERMEDAD	consolidacion multifocal en ambos campos pulmonares
trombo de 5 mm en la punta del VI	trombo de 5 mm en la punta del VI	ENFERMEDAD	trombo de 5 mm en la punta del VI
cardiomiopatia isquemica	cardiomiopatia isquemica	ENFERMEDAD	cardiomiopatia isquemica
T3 libre	T3 libre	ENTIDAD-OBSERVABLE	T3 libre
hidroclorotiazida	hidroclorotiazida	FARMACO	hidroclorotiazida
angiografia pulmonar	angiografia pulmonar	PROCEDIMIENTO	angiografia pulmonar
corticosteroides sistemicos	corticosteroides sistemicos	PROCEDIMIENTO	corticosteroides sistemicos
varicela zoster	varicela zoster	ENFERMEDAD	varicela zoster
hombre (species)	hombre	SPECIES	hombre
aumento de la concentracion de dimero D en	aumento de la concentracion de dimero D en	SINTOMA	aumento de la concentracion de dimero D en
29 anos	29 anos	EDAD-SUJETO-ASISTENCIA	29 anos
15 de mayo	15 de mayo	FECHAS	15 de mayo
intubacion endotraqueal	intubacion endotraqueal	PROCEDIMIENTO	intubacion endotraqueal
inflamacion linfocitica perivascular y perianexial	inflamacion linfocitica perivascular y perianexial	SINTOMA	inflamacion linfocitica perivascular y perianexial
glucosa	glucosa	FARMACO	glucosa
proteina serica	proteina serica	ENTIDAD-OBSERVABLE	proteina serica
aumento del segmento ST en las derivaciones v1v2 y aVR	aumento del segmento ST en las derivaciones v1v2 y aVR	SINTOMA	aumento del segmento ST en las derivaciones v1v2 y aVR
hemocultivos hubo crecimiento de enterococcus faecium resistente a vancomicna y staphylococcus epidermidis	hemocultivos hubo crecimiento de enterococcus faecium resistente a vancomicna y staphylococcus epidermidis	ENFERMEDAD	hemocultivos hubo crecimiento de enterococcus faecium resistente a vancomicna y staphylococcus epidermidis
heparina	heparina	FARMACO	heparina
TAC toracica sin contraste	TAC toracica sin contraste	PROCEDIMIENTO	TAC toracica sin contraste
lactatodeshidrogenasa (entidad-observable)	lactatodeshidrogenasa	ENTIDAD-OBSERVABLE	lactatodeshidrogenasa
Hb (proteinas)	Hb	PROTEINAS	Hb
TAC craneomaxilofacial	TAC craneomaxilofacial	PROCEDIMIENTO	TAC craneomaxilofacial
anamnesis	anamnesis	PROCEDIMIENTO	anamnesis
22 de marzo de 2020	22 de marzo de 2020	FECHAS	22 de marzo de 2020
antiinflamatorios	antiinflamatorios	PROCEDIMIENTO	antiinflamatorios
disnea	disnea	SINTOMA	disnea
elevacion concaviforme y difusa del ST	elevacion concaviforme y difusa del ST	SINTOMA	elevacion concaviforme y difusa del ST
inmunoglobulinas	inmunoglobulinas	PROTEINAS	inmunoglobulinas
30 anos	30 anos	EDAD-SUJETO-ASISTENCIA	30 anos
anticuerpos antitrombociticos	anticuerpos antitrombociticos	PROTEINAS	anticuerpos antitrombociticos
fumador (enfermedad)	fumador	ENFERMEDAD	fumador
vih1 (proteinas)	vih1	PROTEINAS	vih1
cardiomegalia (sintoma)	cardiomegalia	SINTOMA	cardiomegalia
necrosis con ulceracion de la mucosa de 12mm en cara anterior del ciego	necrosis con ulceracion de la mucosa de 12mm en cara anterior del ciego	ENFERMEDAD	necrosis con ulceracion de la mucosa de 12mm en cara anterior del ciego
ampar	ampar	PROTEINAS	ampar
ciudad de la zona roja	ciudad de la zona roja	CALLE	ciudad de la zona roja
taquipnea	taquipnea	SINTOMA	taquipnea
cardiopatias	cardiopatias	ENFERMEDAD	cardiopatias
analisis del liquido cefalorraquideo	analisis del liquido cefalorraquideo	PROCEDIMIENTO	analisis del liquido cefalorraquideo
piperacilina	piperacilina	FARMACO	piperacilina
diabetes gestacional	diabetes gestacional	ENFERMEDAD	diabetes gestacional
hiponatremia	hiponatremia	ENFERMEDAD	hiponatremia
dispepsia (enfermedad)	dispepsia	ENFERMEDAD	dispepsia
RMN cerebral y raquidea	RMN cerebral y raquidea	PROCEDIMIENTO	RMN cerebral y raquidea
glucano serico	glucano serico	ENTIDAD-OBSERVABLE	glucano serico
cloroquina	cloroquina	FARMACO	cloroquina
lactato	lactato	FARMACO	lactato
spo2	spo2	ENTIDAD-OBSERVABLE	spo2
lesiones en ambos pulmones	lesiones en ambos pulmones	ENFERMEDAD	lesiones en ambos pulmones
PUM	PUM	ENTIDAD-OBSERVABLE	PUM
formalina	formalina	FARMACO	formalina
crepitantes en ambos pulmones	crepitantes en ambos pulmones	SINTOMA	crepitantes en ambos pulmones
ecocardiograma transtoracico	ecocardiograma transtoracico	PROCEDIMIENTO	ecocardiograma transtoracico
insuficiencia renal	insuficiencia renal	ENFERMEDAD	insuficiencia renal
hongos	hongos	SPECIES	hongos
estudios de coagulacion	estudios de coagulacion	PROCEDIMIENTO	estudios de coagulacion
dolor en las extremidades inferiores	dolor en las extremidades inferiores	SINTOMA	dolor en las extremidades inferiores
vasoactivos	vasoactivos	PROCEDIMIENTO	vasoactivos
tromboembolia pulmonar	tromboembolia pulmonar	ENFERMEDAD	tromboembolia pulmonar
aguda	aguda	ENFERMEDAD	aguda
recien nacido	recien nacido	ENFERMEDAD	recien nacido
infiltrados inflamatorios mononucleares intersticiales	infiltrados inflamatorios mononucleares intersticiales	SINTOMA	infiltrados inflamatorios mononucleares intersticiales
dilatacion ventricular (enfermedad)	dilatacion ventricular	ENFERMEDAD	dilatacion ventricular
prednisona	prednisona	FARMACO	prednisona
insulina (proteinas)	insulina	PROTEINAS	insulina
infiltrados pulmonares	infiltrados pulmonares	SINTOMA	infiltrados pulmonares
analisis histologico placentario	analisis histologico placentario	PROCEDIMIENTO	analisis histologico placentario
39 anos	39 anos	EDAD-SUJETO-ASISTENCIA	39 anos
bulto en crecimiento palpable en su region parietal	bulto en crecimiento palpable en su region parietal	SINTOMA	bulto en crecimiento palpable en su region parietal
INR	INR	ENTIDAD-OBSERVABLE	INR
estatinas	estatinas	FARMACO	estatinas
escherichia coli	escherichia coli	SPECIES	escherichia coli
auscultacion toracica	auscultacion toracica	PROCEDIMIENTO	auscultacion toracica
timpanometria endoscopica	timpanometria endoscopica	PROCEDIMIENTO	timpanometria endoscopica
rtpcr (proteinas)	rtpcr	PROTEINAS	rtpcr
inmunoglobulina humana	inmunoglobulina humana	PROTEINAS	inmunoglobulina humana
troponina I (entidad-observable)	troponina I	ENTIDAD-OBSERVABLE	troponina I
dolor a la palpacion	dolor a la palpacion	SINTOMA	dolor a la palpacion
ensayo rtpcr del LCR	ensayo rtpcr del LCR	PROCEDIMIENTO	ensayo rtpcr del LCR
TVP bilateral	TVP bilateral	ENFERMEDAD	TVP bilateral
analisis de orina mediante cateter	analisis de orina mediante cateter	PROCEDIMIENTO	analisis de orina mediante cateter
tromboplastina	tromboplastina	PROTEINAS	tromboplastina
frecuencia respiratoria	frecuencia respiratoria	ENTIDAD-OBSERVABLE	frecuencia respiratoria
disminucion de la saturacion de oxigeno	disminucion de la saturacion de oxigeno	SINTOMA	disminucion de la saturacion de oxigeno
buen estado de salud general	buen estado de salud general	SINTOMA	buen estado de salud general
norepinefrina	norepinefrina	FARMACO	norepinefrina
betahidroxibutirato	betahidroxibutirato	PROTEINAS	betahidroxibutirato
cloruro	cloruro	FARMACO	cloruro
CPK (entidad-observable)	CPK	ENTIDAD-OBSERVABLE	CPK
prueba rtpcr	prueba rtpcr	PROCEDIMIENTO	prueba rtpcr
antibioticos y antifungicos	antibioticos y antifungicos	PROCEDIMIENTO	antibioticos y antifungicos
aumento de neutrofilos	aumento de neutrofilos	SINTOMA	aumento de neutrofilos
afasia global	afasia global	SINTOMA	afasia global
sindrome meningeo	sindrome meningeo	ENFERMEDAD	sindrome meningeo
PCR de sarscov2	PCR de sarscov2	PROCEDIMIENTO	PCR de sarscov2
toxoplasma gondii (species)	toxoplasma gondii	SPECIES	toxoplasma gondii
taquicardia sinusal	taquicardia sinusal	ENFERMEDAD	taquicardia sinusal
virus de la hepatitis B	virus de la hepatitis B	SPECIES	virus de la hepatitis B
acufenos	acufenos	SINTOMA	acufenos
PCR de LCR	PCR de LCR	PROCEDIMIENTO	PCR de LCR
linfoadenopatia mediastinica	linfoadenopatia mediastinica	ENFERMEDAD	linfoadenopatia mediastinica
hipocinesia de los segmentos inferior e inferolateral del ventriculo (enfermedad)	hipocinesia de los segmentos inferior e inferolateral del ventriculo	ENFERMEDAD	hipocinesia de los segmentos inferior e inferolateral del ventriculo
mesalazina	mesalazina	FARMACO	mesalazina
dermatosis inflamatorias	dermatosis inflamatorias	ENFERMEDAD	dermatosis inflamatorias
sarscov2 (farmaco)	sarscov2	FARMACO	sarscov2
electromiograma	electromiograma	PROCEDIMIENTO	electromiograma
aspiracion del esputo	aspiracion del esputo	PROCEDIMIENTO	aspiracion del esputo
6 de marzo de 2020	6 de marzo de 2020	FECHAS	6 de marzo de 2020
panel de patogenos respiratorios	panel de patogenos respiratorios	PROCEDIMIENTO	panel de patogenos respiratorios
sindrome de dificultad respiratoria aguda	sindrome de dificultad respiratoria aguda	ENFERMEDAD	sindrome de dificultad respiratoria aguda
2 de abril	2 de abril	FECHAS	2 de abril
21 anos	21 anos	EDAD-SUJETO-ASISTENCIA	21 anos
metformina	metformina	FARMACO	metformina
virus de la gripe A	virus de la gripe A	SPECIES	virus de la gripe A
apendicitis aguda	apendicitis aguda	ENFERMEDAD	apendicitis aguda
psoriasis cronica en placas moderada	psoriasis cronica en placas moderada	ENFERMEDAD	psoriasis cronica en placas moderada
interferon (proteinas)	interferon	PROTEINAS	interferon
IL6 (proteinas)	IL6	PROTEINAS	IL6
infeccion de las vias respiratorias altas	infeccion de las vias respiratorias altas	ENFERMEDAD	infeccion de las vias respiratorias altas
2dia	2dia	FARMACO	2dia
abrasiones en los labios y mucosa bucal	abrasiones en los labios y mucosa bucal	ENFERMEDAD	abrasiones en los labios y mucosa bucal
diarrea intermitente	diarrea intermitente	ENFERMEDAD	diarrea intermitente
tiempo total	tiempo total	ENTIDAD-OBSERVABLE	tiempo total
presion parcial de oxigeno arterial	presion parcial de oxigeno arterial	ENTIDAD-OBSERVABLE	presion parcial de oxigeno arterial
15 de marzo de 2020	15 de marzo de 2020	FECHAS	15 de marzo de 2020
frotis nasofaringeos y orofaringeos	frotis nasofaringeos y orofaringeos	PROCEDIMIENTO	frotis nasofaringeos y orofaringeos
sobrepeso	sobrepeso	ENFERMEDAD	sobrepeso
presion arterial	presion arterial	ENTIDAD-OBSERVABLE	presion arterial
estados unidos	estados unidos	PAIS	estados unidos
artritis reumatoide	artritis reumatoide	ENFERMEDAD	artritis reumatoide
fetales de parto	fetales de parto	ENFERMEDAD	fetales de parto
marcadores de inflamacion	marcadores de inflamacion	ENTIDAD-OBSERVABLE	marcadores de inflamacion
benralizumab	benralizumab	FARMACO	benralizumab
ciclofosfamida	ciclofosfamida	FARMACO	ciclofosfamida
levofloxacina	levofloxacina	FARMACO	levofloxacina
anosmiaageusia	anosmiaageusia	SINTOMA	anosmiaageusia
disminucion de los ruidos respiratorios con crepitantes en el campo pulmonar izquierdo inferior	disminucion de los ruidos respiratorios con crepitantes en el campo pulmonar izquierdo inferior	SINTOMA	disminucion de los ruidos respiratorios con crepitantes en el campo pulmonar izquierdo inferior
cambios en su frecuencia de orina y defecaciones	cambios en su frecuencia de orina y defecaciones	SINTOMA	cambios en su frecuencia de orina y defecaciones
crepitantes	crepitantes	SINTOMA	crepitantes
hemograma	hemograma	PROCEDIMIENTO	hemograma
diarrea (sintoma)	diarrea	SINTOMA	diarrea
vial de meronepem	vial de meronepem	PROCEDIMIENTO	vial de meronepem
diabetes tipo 2	diabetes tipo 2	ENFERMEDAD	diabetes tipo 2
glutamiltransferasa (proteinas)	glutamiltransferasa	PROTEINAS	glutamiltransferasa
carcinoma de celulas escamosas hipofaringeo	carcinoma de celulas escamosas hipofaringeo	ENFERMEDAD	carcinoma de celulas escamosas hipofaringeo
marzo	marzo	FECHAS	marzo
tratamiento diuretico	tratamiento diuretico	PROCEDIMIENTO	tratamiento diuretico
arritmia	arritmia	ENFERMEDAD	arritmia
choque cardiogenico	choque cardiogenico	ENFERMEDAD	choque cardiogenico
sarcoidosis alveolar	sarcoidosis alveolar	ENFERMEDAD	sarcoidosis alveolar
desplazamiento mediastinico	desplazamiento mediastinico	ENFERMEDAD	desplazamiento mediastinico
diarrea (enfermedad)	diarrea	ENFERMEDAD	diarrea
sintomas abdominales	sintomas abdominales	SINTOMA	sintomas abdominales
92 anos	92 anos	EDAD-SUJETO-ASISTENCIA	92 anos
presion parcial de oxigeno	presion parcial de oxigeno	ENTIDAD-OBSERVABLE	presion parcial de oxigeno
diabetes de tipo 2	diabetes de tipo 2	ENFERMEDAD	diabetes de tipo 2
auscultacion pulmonar	auscultacion pulmonar	PROCEDIMIENTO	auscultacion pulmonar
encefalopatia	encefalopatia	ENFERMEDAD	encefalopatia
varon	varon	SEXO-SUJETO-ASISTENCIA	varon
polimerasa	polimerasa	PROTEINAS	polimerasa
antibioticos orales	antibioticos orales	PROCEDIMIENTO	antibioticos orales
levotiroxina	levotiroxina	FARMACO	levotiroxina
ALT (entidad-observable)	ALT	ENTIDAD-OBSERVABLE	ALT
29	29	FECHAS	29
34 anos	34 anos	EDAD-SUJETO-ASISTENCIA	34 anos
TnI (proteinas)	TnI	PROTEINAS	TnI
anticuerpos anticitoplasmicos de neutrofilos (proteinas)	anticuerpos anticitoplasmicos de neutrofilos	PROTEINAS	anticuerpos anticitoplasmicos de neutrofilos
abidol	abidol	FARMACO	abidol
disminucion significativa de la hiperintensidad del cortex prefrontal	disminucion significativa de la hiperintensidad del cortex prefrontal	SINTOMA	disminucion significativa de la hiperintensidad del cortex prefrontal
consumo de oxigeno decreciente	consumo de oxigeno decreciente	SINTOMA	consumo de oxigeno decreciente
interferon  (proteinas)	interferon 	PROTEINAS	interferon 
eritema polimorfo grave	eritema polimorfo grave	ENFERMEDAD	eritema polimorfo grave
26 de marzo de 2020	26 de marzo de 2020	FECHAS	26 de marzo de 2020
calcineurina	calcineurina	FARMACO	calcineurina
albuterol	albuterol	FARMACO	albuterol
infeccion pulmonar	infeccion pulmonar	ENFERMEDAD	infeccion pulmonar
acetaminofen	acetaminofen	FARMACO	acetaminofen
enzimas hepaticas (entidad-observable)	enzimas hepaticas	ENTIDAD-OBSERVABLE	enzimas hepaticas
ANA (entidad-observable)	ANA	ENTIDAD-OBSERVABLE	ANA
19 de enero	19 de enero	FECHAS	19 de enero
30 de marzo	30 de marzo	FECHAS	30 de marzo
Hu	Hu	PROTEINAS	Hu
TC abdominal	TC abdominal	PROCEDIMIENTO	TC abdominal
afasia	afasia	SINTOMA	afasia
hipotension (sintoma)	hipotension	SINTOMA	hipotension
infeccion virica	infeccion virica	ENFERMEDAD	infeccion virica
confusion	confusion	SINTOMA	confusion
bicarbonato	bicarbonato	FARMACO	bicarbonato
leucocitopenia (enfermedad)	leucocitopenia	ENFERMEDAD	leucocitopenia
virus de la hepatitis C	virus de la hepatitis C	SPECIES	virus de la hepatitis C
inmunoglobulina (proteinas)	inmunoglobulina	PROTEINAS	inmunoglobulina
hipernatremia	hipernatremia	ENFERMEDAD	hipernatremia
frotis nasales	frotis nasales	PROCEDIMIENTO	frotis nasales
disfagia	disfagia	SINTOMA	disfagia
TAC abdominal	TAC abdominal	PROCEDIMIENTO	TAC abdominal
75 anos	75 anos	EDAD-SUJETO-ASISTENCIA	75 anos
estertores humedos en las bases de ambos pulmones	estertores humedos en las bases de ambos pulmones	SINTOMA	estertores humedos en las bases de ambos pulmones
neumonia	neumonia	ENFERMEDAD	neumonia
sintomas respiratorios	sintomas respiratorios	SINTOMA	sintomas respiratorios
de la sexta vertebra toracica	de la sexta vertebra toracica	ENFERMEDAD	de la sexta vertebra toracica
insuficiencia respiratoria aguda	insuficiencia respiratoria aguda	ENFERMEDAD	insuficiencia respiratoria aguda
receptor	receptor	PROTEINAS	receptor
aspartatoaminotransferasa (proteinas)	aspartatoaminotransferasa	PROTEINAS	aspartatoaminotransferasa
IFN B (farmaco)	IFN B	FARMACO	IFN B
cardiopatia isquemica	cardiopatia isquemica	ENFERMEDAD	cardiopatia isquemica
12 de covid	12 de covid	FECHAS	12 de covid
31 de enero	31 de enero	FECHAS	31 de enero
loratadina	loratadina	FARMACO	loratadina
hiperlipidemia	hiperlipidemia	ENFERMEDAD	hiperlipidemia
anticuerpos antinucleares (proteinas)	anticuerpos antinucleares	PROTEINAS	anticuerpos antinucleares
shanghai	shanghai	TERRITORIO	shanghai
microgramo	microgramo	FARMACO	microgramo
aborto	aborto	ENFERMEDAD	aborto
neumonia por sarscov2	neumonia por sarscov2	ENFERMEDAD	neumonia por sarscov2
enfisema	enfisema	ENFERMEDAD	enfisema
imipenem	imipenem	FARMACO	imipenem
13 de febrero	13 de febrero	FECHAS	13 de febrero
ritonavir	ritonavir	FARMACO	ritonavir
salina isotonica	salina isotonica	FARMACO	salina isotonica
sibilancias en ambos pulmones y edema periferico	sibilancias en ambos pulmones y edema periferico	SINTOMA	sibilancias en ambos pulmones y edema periferico
intubacion	intubacion	PROCEDIMIENTO	intubacion
hipertension	hipertension	ENFERMEDAD	hipertension
cardiomegalia (enfermedad)	cardiomegalia	ENFERMEDAD	cardiomegalia
neuropatia aguda sensitivomotora axonica	neuropatia aguda sensitivomotora axonica	ENFERMEDAD	neuropatia aguda sensitivomotora axonica
TSH (entidad-observable)	TSH	ENTIDAD-OBSERVABLE	TSH
FDA	FDA	FARMACO	FDA
18 de febrero de 2020	18 de febrero de 2020	FECHAS	18 de febrero de 2020
virus de la hepatitis A	virus de la hepatitis A	SPECIES	virus de la hepatitis A
vasopresina (farmaco)	vasopresina	FARMACO	vasopresina
carga viral	carga viral	ENTIDAD-OBSERVABLE	carga viral
80 anos	80 anos	EDAD-SUJETO-ASISTENCIA	80 anos
proteina amiloide A	proteina amiloide A	PROTEINAS	proteina amiloide A
EMG	EMG	PROCEDIMIENTO	EMG
trombosis venosa profunda	trombosis venosa profunda	ENFERMEDAD	trombosis venosa profunda
gammaglobulina	gammaglobulina	PROTEINAS	gammaglobulina
T totales	T totales	PROTEINAS	T totales
brasil	brasil	PAIS	brasil
prueba para sarscov2	prueba para sarscov2	PROCEDIMIENTO	prueba para sarscov2
febril	febril	SINTOMA	febril
malestar agudo	malestar agudo	SINTOMA	malestar agudo
IgG de VCH	IgG de VCH	PROTEINAS	IgG de VCH
streptococcus pneumoniae	streptococcus pneumoniae	SPECIES	streptococcus pneumoniae
miocarditis	miocarditis	ENFERMEDAD	miocarditis
congestion nasal	congestion nasal	SINTOMA	congestion nasal
sulbactam	sulbactam	FARMACO	sulbactam
dificultad respiratoria aguda	dificultad respiratoria aguda	SINTOMA	dificultad respiratoria aguda
leucocitopenia (proteinas)	leucocitopenia	PROTEINAS	leucocitopenia
acido lactico	acido lactico	FARMACO	acido lactico
difenhidramina	difenhidramina	FARMACO	difenhidramina
hco3	hco3	FARMACO	hco3
folato	folato	FARMACO	folato
delirio confusional (sintoma)	delirio confusional	SINTOMA	delirio confusional
tocilizumab (farmaco)	tocilizumab	FARMACO	tocilizumab
aciclovir	aciclovir	FARMACO	aciclovir
hombre (sexo-sujeto-asistencia)	hombre	SEXO-SUJETO-ASISTENCIA	hombre
hemorragia	hemorragia	ENFERMEDAD	hemorragia
cardioembolica	cardioembolica	ENFERMEDAD	cardioembolica
estertores bronquiales	estertores bronquiales	SINTOMA	estertores bronquiales
covid19 en la zona epidemica	covid19 en la zona epidemica	ENFERMEDAD	covid19 en la zona epidemica
hipertension pulmonar	hipertension pulmonar	ENFERMEDAD	hipertension pulmonar
criptococo	criptococo	SPECIES	criptococo
paracetamol	paracetamol	FARMACO	paracetamol
creatinacinasa (proteinas)	creatinacinasa	PROTEINAS	creatinacinasa
malestar general	malestar general	SINTOMA	malestar general
marzo de 2020	marzo de 2020	FECHAS	marzo de 2020
mioglobina	mioglobina	PROTEINAS	mioglobina
exantema pruriginoso	exantema pruriginoso	SINTOMA	exantema pruriginoso
fibrilacion auricular	fibrilacion auricular	ENFERMEDAD	fibrilacion auricular
diabetes mellitus de tipo II	diabetes mellitus de tipo II	ENFERMEDAD	diabetes mellitus de tipo II
dimero D (proteinas)	dimero D	PROTEINAS	dimero D
ritmo sinusal	ritmo sinusal	SINTOMA	ritmo sinusal
hipoxia	hipoxia	ENFERMEDAD	hipoxia
linfoadenopatia (sintoma)	linfoadenopatia	SINTOMA	linfoadenopatia
tratamiento antivirico	tratamiento antivirico	PROCEDIMIENTO	tratamiento antivirico
mascarilla N95	mascarilla N95	PROCEDIMIENTO	mascarilla N95
analisis histopatologico de la tromboembolectomia	analisis histopatologico de la tromboembolectomia	PROCEDIMIENTO	analisis histopatologico de la tromboembolectomia
proteinuria	proteinuria	SINTOMA	proteinuria
tos no productiva	tos no productiva	SINTOMA	tos no productiva
adenovirus	adenovirus	SPECIES	adenovirus
2011	2011	FECHAS	2011
pruebas de acido nucleico del sarscov2	pruebas de acido nucleico del sarscov2	PROCEDIMIENTO	pruebas de acido nucleico del sarscov2
artralgia	artralgia	SINTOMA	artralgia
TAC toracica de la madre	TAC toracica de la madre	PROCEDIMIENTO	TAC toracica de la madre
provincia de hubei	provincia de hubei	TERRITORIO	provincia de hubei
10 de marzo	10 de marzo	FECHAS	10 de marzo
ACE serica	ACE serica	ENTIDAD-OBSERVABLE	ACE serica
anemia	anemia	ENFERMEDAD	anemia
dolor abdominal	dolor abdominal	SINTOMA	dolor abdominal
artromialgia	artromialgia	SINTOMA	artromialgia
procalcitonina (entidad-observable)	procalcitonina	ENTIDAD-OBSERVABLE	procalcitonina
congestion conjuntival	congestion conjuntival	SINTOMA	congestion conjuntival
citrobacter freundii	citrobacter freundii	SPECIES	citrobacter freundii
inestabilidad cardiovascular	inestabilidad cardiovascular	SINTOMA	inestabilidad cardiovascular
parto (enfermedad)	parto	ENFERMEDAD	parto
esteroides (farmaco)	esteroides	FARMACO	esteroides
analisis moleculares	analisis moleculares	PROCEDIMIENTO	analisis moleculares
mepolizumab	mepolizumab	FARMACO	mepolizumab
somnoliento	somnoliento	SINTOMA	somnoliento
pangolines	pangolines	SPECIES	pangolines
alargamiento del QT	alargamiento del QT	ENFERMEDAD	alargamiento del QT
fenobarbital	fenobarbital	FARMACO	fenobarbital
27 de febrero	27 de febrero	FECHAS	27 de febrero
RMN vertebral	RMN vertebral	PROCEDIMIENTO	RMN vertebral
hemodinamicamente inestable	hemodinamicamente inestable	SINTOMA	hemodinamicamente inestable
tos seca convulsiva	tos seca convulsiva	SINTOMA	tos seca convulsiva
7 de marzo	7 de marzo	FECHAS	7 de marzo
hormona antidiuretica	hormona antidiuretica	PROTEINAS	hormona antidiuretica
prostaglandina	prostaglandina	FARMACO	prostaglandina
frotis	frotis	PROCEDIMIENTO	frotis
antibioticos	antibioticos	PROCEDIMIENTO	antibioticos
84 anos	84 anos	EDAD-SUJETO-ASISTENCIA	84 anos
escocia	escocia	PAIS	escocia
linfoma linfoblastico B	linfoma linfoblastico B	ENFERMEDAD	linfoma linfoblastico B
ttpa	ttpa	ENTIDAD-OBSERVABLE	ttpa
anomalias sospechosas en la medula espinal	anomalias sospechosas en la medula espinal	ENFERMEDAD	anomalias sospechosas en la medula espinal
paro cardiaco	paro cardiaco	ENFERMEDAD	paro cardiaco
tos	tos	SINTOMA	tos
ventilacion mecanica	ventilacion mecanica	PROCEDIMIENTO	ventilacion mecanica
pruebas funcionales hepaticas	pruebas funcionales hepaticas	PROCEDIMIENTO	pruebas funcionales hepaticas
prohormona	prohormona	PROTEINAS	prohormona
sulfato de magnesio	sulfato de magnesio	FARMACO	sulfato de magnesio
TAC de las fosas nasales (sintoma)	TAC de las fosas nasales	SINTOMA	TAC de las fosas nasales
hormonas tiroideas	hormonas tiroideas	FARMACO	hormonas tiroideas
exploracion histologica	exploracion histologica	PROCEDIMIENTO	exploracion histologica
interleucina 6	interleucina 6	PROTEINAS	interleucina 6
sdra grave	sdra grave	ENFERMEDAD	sdra grave
radiografias toracicas	radiografias toracicas	PROCEDIMIENTO	radiografias toracicas
frotis nasofaringeos	frotis nasofaringeos	PROCEDIMIENTO	frotis nasofaringeos
erupcion de placas eritematosas pruriginosas	erupcion de placas eritematosas pruriginosas	ENFERMEDAD	erupcion de placas eritematosas pruriginosas
TAC toracicas	TAC toracicas	PROCEDIMIENTO	TAC toracicas
creatinafosfocinasa (proteinas)	creatinafosfocinasa	PROTEINAS	creatinafosfocinasa
sindrome respiratorio agudo grave de coronavirus	sindrome respiratorio agudo grave de coronavirus	ENFERMEDAD	sindrome respiratorio agudo grave de coronavirus
derrame pleural	derrame pleural	ENFERMEDAD	derrame pleural
glutamiltransferasa (entidad-observable)	glutamiltransferasa	ENTIDAD-OBSERVABLE	glutamiltransferasa
deterioro de la funcion renal	deterioro de la funcion renal	SINTOMA	deterioro de la funcion renal
proteina creactiva (proteinas)	proteina creactiva	PROTEINAS	proteina creactiva
IgG	IgG	PROTEINAS	IgG
fibrina	fibrina	PROTEINAS	fibrina
gentamicina	gentamicina	FARMACO	gentamicina
neumotorax bilateral	neumotorax bilateral	ENFERMEDAD	neumotorax bilateral
frotis de sangre	frotis de sangre	PROCEDIMIENTO	frotis de sangre
inmunoglobulina (farmaco)	inmunoglobulina	FARMACO	inmunoglobulina
21 de enero de 2020	21 de enero de 2020	FECHAS	21 de enero de 2020
RMN toracica craneal y lumbar	RMN toracica craneal y lumbar	PROCEDIMIENTO	RMN toracica craneal y lumbar
sdmo	sdmo	FARMACO	sdmo
IFN B (proteinas)	IFN B	PROTEINAS	IFN B
angiografia	angiografia	PROCEDIMIENTO	angiografia
mialgia (farmaco)	mialgia	FARMACO	mialgia
ceftriaxona	ceftriaxona	FARMACO	ceftriaxona
prueba molecular de sarscov2	prueba molecular de sarscov2	PROCEDIMIENTO	prueba molecular de sarscov2
oxigeno (farmaco)	oxigeno	FARMACO	oxigeno
fallecio (sintoma)	fallecio	SINTOMA	fallecio
auscultacion pulmonar posterior	auscultacion pulmonar posterior	PROCEDIMIENTO	auscultacion pulmonar posterior
telemetria	telemetria	PROCEDIMIENTO	telemetria
descompresion urgente de su neumotorax	descompresion urgente de su neumotorax	PROCEDIMIENTO	descompresion urgente de su neumotorax
hepatomegalia (sintoma)	hepatomegalia	SINTOMA	hepatomegalia
malestar intenso	malestar intenso	SINTOMA	malestar intenso
interferon gamma (proteinas)	interferon gamma	PROTEINAS	interferon gamma
bypass gastrico (enfermedad)	bypass gastrico	ENFERMEDAD	bypass gastrico
infiltrados pulmonares intersticiales	infiltrados pulmonares intersticiales	SINTOMA	infiltrados pulmonares intersticiales
aminotransferasa (farmaco)	aminotransferasa	FARMACO	aminotransferasa
alanina	alanina	PROTEINAS	alanina
metilprednisolona	metilprednisolona	FARMACO	metilprednisolona
Xa	Xa	PROTEINAS	Xa
ecuatorial	ecuatorial	PAIS	ecuatorial
17 de marzo	17 de marzo	FECHAS	17 de marzo
consolidacion mixta segmentaria	consolidacion mixta segmentaria	ENFERMEDAD	consolidacion mixta segmentaria
adenopatia en el lado derecho del cuello	adenopatia en el lado derecho del cuello	ENFERMEDAD	adenopatia en el lado derecho del cuello
vasopresina (proteinas)	vasopresina	PROTEINAS	vasopresina
disnea espiratoria	disnea espiratoria	SINTOMA	disnea espiratoria
insomnio (sintoma)	insomnio	SINTOMA	insomnio
interferon beta (farmaco)	interferon beta	FARMACO	interferon beta
13 de noviembre de 2019	13 de noviembre de 2019	FECHAS	13 de noviembre de 2019
opacidades de vidrio esmerilado en la parte superior del pulmon	opacidades de vidrio esmerilado en la parte superior del pulmon	SINTOMA	opacidades de vidrio esmerilado en la parte superior del pulmon
deterioro cognitivo	deterioro cognitivo	SINTOMA	deterioro cognitivo
angiotomografia	angiotomografia	PROCEDIMIENTO	angiotomografia
radiografia toracica anteroposterior	radiografia toracica anteroposterior	PROCEDIMIENTO	radiografia toracica anteroposterior
enfermedad cerebrovascular	enfermedad cerebrovascular	ENFERMEDAD	enfermedad cerebrovascular
PPC	PPC	ENTIDAD-OBSERVABLE	PPC
estudios de conduccion nerviosa sensorial	estudios de conduccion nerviosa sensorial	PROCEDIMIENTO	estudios de conduccion nerviosa sensorial
biopsia de piel del hombro izquierdo	biopsia de piel del hombro izquierdo	PROCEDIMIENTO	biopsia de piel del hombro izquierdo
6 meses	6 meses	EDAD-SUJETO-ASISTENCIA	6 meses
neumonia multifocal	neumonia multifocal	ENFERMEDAD	neumonia multifocal
saturacion de oxigeno (entidad-observable)	saturacion de oxigeno	ENTIDAD-OBSERVABLE	saturacion de oxigeno
amiodarona	amiodarona	FARMACO	amiodarona
mayo de 2020	mayo de 2020	FECHAS	mayo de 2020
ecografia renal	ecografia renal	PROCEDIMIENTO	ecografia renal
administracion del antibiotico	administracion del antibiotico	PROCEDIMIENTO	administracion del antibiotico
milrinona	milrinona	FARMACO	milrinona
actividad	actividad	ENTIDAD-OBSERVABLE	actividad
aine loxoprofeno	aine loxoprofeno	FARMACO	aine loxoprofeno
Cr	Cr	FARMACO	Cr
oxido	oxido	FARMACO	oxido
febrero	febrero	FECHAS	febrero
32 anos	32 anos	EDAD-SUJETO-ASISTENCIA	32 anos
meronepem	meronepem	FARMACO	meronepem
anticoagulantes preventivos	anticoagulantes preventivos	PROCEDIMIENTO	anticoagulantes preventivos
ecocardiografia a pie de cama	ecocardiografia a pie de cama	PROCEDIMIENTO	ecocardiografia a pie de cama
exantema en las extremidades inferiores (sintoma)	exantema en las extremidades inferiores	SINTOMA	exantema en las extremidades inferiores
hematocrito	hematocrito	ENTIDAD-OBSERVABLE	hematocrito
neumonia grave por covid19	neumonia grave por covid19	ENFERMEDAD	neumonia grave por covid19
BCG	BCG	FARMACO	BCG
gripe	gripe	ENFERMEDAD	gripe
adrenalina	adrenalina	FARMACO	adrenalina
bicitopenia	bicitopenia	ENFERMEDAD	bicitopenia
hemoglobina (proteinas)	hemoglobina	PROTEINAS	hemoglobina
paralisis facial	paralisis facial	ENFERMEDAD	paralisis facial
corticoesteroides (farmaco)	corticoesteroides	FARMACO	corticoesteroides
fibrobroncoscopia	fibrobroncoscopia	PROCEDIMIENTO	fibrobroncoscopia
infiltrados parcheados bilaterales en ambos pulmones	infiltrados parcheados bilaterales en ambos pulmones	SINTOMA	infiltrados parcheados bilaterales en ambos pulmones
noradrenalina	noradrenalina	FARMACO	noradrenalina
disminucion de la asat	disminucion de la asat	SINTOMA	disminucion de la asat
delirio (enfermedad)	delirio	ENFERMEDAD	delirio
francesas	francesas	PAIS	francesas
diarreas	diarreas	SINTOMA	diarreas
adenocarcinoma en el pulmon	adenocarcinoma en el pulmon	ENFERMEDAD	adenocarcinoma en el pulmon
anfotericina	anfotericina	FARMACO	anfotericina
parto por cesarea (procedimiento)	parto por cesarea	PROCEDIMIENTO	parto por cesarea
aumento de la proteina creactiva	aumento de la proteina creactiva	SINTOMA	aumento de la proteina creactiva
biopsias de los pulmones	biopsias de los pulmones	PROCEDIMIENTO	biopsias de los pulmones
pseudomonas aeruginosa	pseudomonas aeruginosa	SPECIES	pseudomonas aeruginosa
IMC	IMC	ENTIDAD-OBSERVABLE	IMC
potasio serico	potasio serico	ENTIDAD-OBSERVABLE	potasio serico
saturacion venosa	saturacion venosa	ENTIDAD-OBSERVABLE	saturacion venosa
aspirado de medula osea	aspirado de medula osea	PROCEDIMIENTO	aspirado de medula osea
San diego	San diego	TERRITORIO	San diego
alaninatransaminasa (proteinas)	alaninatransaminasa	PROTEINAS	alaninatransaminasa
colapso parcial del lobulo superior	colapso parcial del lobulo superior	ENFERMEDAD	colapso parcial del lobulo superior
adenopatias mediastinicas	adenopatias mediastinicas	ENFERMEDAD	adenopatias mediastinicas
derrame pericardico perimetral moderado	derrame pericardico perimetral moderado	ENFERMEDAD	derrame pericardico perimetral moderado
pruebas hematologicas	pruebas hematologicas	PROCEDIMIENTO	pruebas hematologicas
infeccion por sarscov2	infeccion por sarscov2	ENFERMEDAD	infeccion por sarscov2
ecografias toracicas	ecografias toracicas	PROCEDIMIENTO	ecografias toracicas
asma eosinofilica grave	asma eosinofilica grave	ENFERMEDAD	asma eosinofilica grave
hipotiroidismo	hipotiroidismo	ENFERMEDAD	hipotiroidismo
sensacion distermica	sensacion distermica	SINTOMA	sensacion distermica
furosemida	furosemida	FARMACO	furosemida
alopurinol	alopurinol	FARMACO	alopurinol
deshidrogenasa lactica (entidad-observable)	deshidrogenasa lactica	ENTIDAD-OBSERVABLE	deshidrogenasa lactica
trombocitopenia (enfermedad)	trombocitopenia	ENFERMEDAD	trombocitopenia
amilasa plasmatica	amilasa plasmatica	ENTIDAD-OBSERVABLE	amilasa plasmatica
oxigenoterapia con canula nasal	oxigenoterapia con canula nasal	PROCEDIMIENTO	oxigenoterapia con canula nasal
TAC pancreatica	TAC pancreatica	PROCEDIMIENTO	TAC pancreatica
leche materna	leche materna	PROCEDIMIENTO	leche materna
hematuria (enfermedad)	hematuria	ENFERMEDAD	hematuria
herpes zoster	herpes zoster	ENFERMEDAD	herpes zoster
disminucion de los marcadores inflamatorios	disminucion de los marcadores inflamatorios	SINTOMA	disminucion de los marcadores inflamatorios
favipiravir	favipiravir	FARMACO	favipiravir
63 anos	63 anos	EDAD-SUJETO-ASISTENCIA	63 anos
estrasburgo	estrasburgo	TERRITORIO	estrasburgo
rana	rana	SPECIES	rana
colestasis	colestasis	ENFERMEDAD	colestasis
pncnt	pncnt	PROTEINAS	pncnt
anticuerpos antifosfolipidicos (entidad-observable)	anticuerpos antifosfolipidicos	ENTIDAD-OBSERVABLE	anticuerpos antifosfolipidicos
letargia	letargia	SINTOMA	letargia
dolor toracico	dolor toracico	SINTOMA	dolor toracico
neumotorax	neumotorax	ENFERMEDAD	neumotorax
presion arterial diastolica	presion arterial diastolica	ENTIDAD-OBSERVABLE	presion arterial diastolica
21 de abril	21 de abril	FECHAS	21 de abril
aumento de perimetro respecto a contralateral	aumento de perimetro respecto a contralateral	SINTOMA	aumento de perimetro respecto a contralateral
sintomas respiratorios leves	sintomas respiratorios leves	SINTOMA	sintomas respiratorios leves
infecciones endemicas	infecciones endemicas	ENFERMEDAD	infecciones endemicas
15 de marzo	15 de marzo	FECHAS	15 de marzo
14 de abril	14 de abril	FECHAS	14 de abril
A	A	SPECIES	A
17 de febrero de 2020	17 de febrero de 2020	FECHAS	17 de febrero de 2020
arteriopatia coronaria	arteriopatia coronaria	ENFERMEDAD	arteriopatia coronaria
cardiopatia coronaria	cardiopatia coronaria	ENFERMEDAD	cardiopatia coronaria
neumonia en la zona inferior del pulmon	neumonia en la zona inferior del pulmon	ENFERMEDAD	neumonia en la zona inferior del pulmon
prueba de sarscov2	prueba de sarscov2	PROCEDIMIENTO	prueba de sarscov2
tensioactivos y ventilacion	tensioactivos y ventilacion	PROCEDIMIENTO	tensioactivos y ventilacion
atorvastatina	atorvastatina	FARMACO	atorvastatina
dialisis	dialisis	PROCEDIMIENTO	dialisis
temperatura	temperatura	ENTIDAD-OBSERVABLE	temperatura
infliximab (proteinas)	infliximab	PROTEINAS	infliximab
azul de metileno	azul de metileno	FARMACO	azul de metileno
virus influenza	virus influenza	SPECIES	virus influenza
CT (farmaco)	CT	FARMACO	CT
peso corporal	peso corporal	ENTIDAD-OBSERVABLE	peso corporal
CDC	CDC	PROTEINAS	CDC
metildopa	metildopa	FARMACO	metildopa
anasarca	anasarca	SINTOMA	anasarca
alerta fluctuante	alerta fluctuante	SINTOMA	alerta fluctuante
5 de febrero	5 de febrero	FECHAS	5 de febrero
cultivo de LCR	cultivo de LCR	PROCEDIMIENTO	cultivo de LCR
creatinina	creatinina	FARMACO	creatinina
cesarea primaria	cesarea primaria	PROCEDIMIENTO	cesarea primaria
taquicardia ventricular	taquicardia ventricular	ENFERMEDAD	taquicardia ventricular
acido acetilsalicilico	acido acetilsalicilico	FARMACO	acido acetilsalicilico
albendazol	albendazol	FARMACO	albendazol
trastorno esquizoafectivo	trastorno esquizoafectivo	ENFERMEDAD	trastorno esquizoafectivo
afecciones cardiopulmonares agudas	afecciones cardiopulmonares agudas	ENFERMEDAD	afecciones cardiopulmonares agudas
vancomicina	vancomicina	FARMACO	vancomicina
12 de marzo de 2020	12 de marzo de 2020	FECHAS	12 de marzo de 2020
24 de enero	24 de enero	FECHAS	24 de enero
factor reumatoide (entidad-observable)	factor reumatoide	ENTIDAD-OBSERVABLE	factor reumatoide
26 anos	26 anos	EDAD-SUJETO-ASISTENCIA	26 anos
69 anos	69 anos	EDAD-SUJETO-ASISTENCIA	69 anos
estudio de conduccion nerviosa	estudio de conduccion nerviosa	PROCEDIMIENTO	estudio de conduccion nerviosa
SGB	SGB	ENFERMEDAD	SGB
olanzapina	olanzapina	FARMACO	olanzapina
mesalamina	mesalamina	FARMACO	mesalamina
estertores gruesos en ambos pulmones	estertores gruesos en ambos pulmones	SINTOMA	estertores gruesos en ambos pulmones
peroxidasa tiroidea	peroxidasa tiroidea	ENTIDAD-OBSERVABLE	peroxidasa tiroidea
16 de abril de 2020	16 de abril de 2020	FECHAS	16 de abril de 2020
ansioso	ansioso	SINTOMA	ansioso
enzimas hepaticas (proteinas)	enzimas hepaticas	PROTEINAS	enzimas hepaticas
20 de marzo de 2020	20 de marzo de 2020	FECHAS	20 de marzo de 2020
reseccion de 150 cm de intestino delgado isquemico	reseccion de 150 cm de intestino delgado isquemico	PROCEDIMIENTO	reseccion de 150 cm de intestino delgado isquemico
tratamiento antibacteriano	tratamiento antibacteriano	PROCEDIMIENTO	tratamiento antibacteriano
TC abdominopelvica	TC abdominopelvica	PROCEDIMIENTO	TC abdominopelvica
aspirados nasofaringeos	aspirados nasofaringeos	PROCEDIMIENTO	aspirados nasofaringeos
deterioro de su estado general	deterioro de su estado general	SINTOMA	deterioro de su estado general
corticoesteroides sistemicos	corticoesteroides sistemicos	PROCEDIMIENTO	corticoesteroides sistemicos
hipercolesterolemia	hipercolesterolemia	ENFERMEDAD	hipercolesterolemia
EDA	EDA	PROCEDIMIENTO	EDA
crisis caracterizada por movimientos clonicos en el brazo	crisis caracterizada por movimientos clonicos en el brazo	ENFERMEDAD	crisis caracterizada por movimientos clonicos en el brazo
afroamericana	afroamericana	ID-SUJETO-ASISTENCIA	afroamericana
apgar	apgar	ENTIDAD-OBSERVABLE	apgar
proteina amiloide A serica	proteina amiloide A serica	ENTIDAD-OBSERVABLE	proteina amiloide A serica
corticosteroides iv	corticosteroides iv	PROCEDIMIENTO	corticosteroides iv
exploracion cardiopulmonar	exploracion cardiopulmonar	PROCEDIMIENTO	exploracion cardiopulmonar
cefpodoxima	cefpodoxima	FARMACO	cefpodoxima
consolidacion parenquimatosa	consolidacion parenquimatosa	ENFERMEDAD	consolidacion parenquimatosa
acidosis transitoria	acidosis transitoria	ENFERMEDAD	acidosis transitoria
lopinavir	lopinavir	FARMACO	lopinavir
provincia de guangdong	provincia de guangdong	TERRITORIO	provincia de guangdong
San francisco	San francisco	TERRITORIO	San francisco
congestion faringea	congestion faringea	SINTOMA	congestion faringea
aspirado nasofaringeo	aspirado nasofaringeo	PROCEDIMIENTO	aspirado nasofaringeo
12 de enero	12 de enero	FECHAS	12 de enero
TAC de alta resolucion	TAC de alta resolucion	PROCEDIMIENTO	TAC de alta resolucion
antihistaminicos	antihistaminicos	PROCEDIMIENTO	antihistaminicos
2003	2003	FECHAS	2003
acivlovir	acivlovir	FARMACO	acivlovir
65 anos	65 anos	EDAD-SUJETO-ASISTENCIA	65 anos
radiografia de torax	radiografia de torax	PROCEDIMIENTO	radiografia de torax
insuficiencia cardiaca aguda	insuficiencia cardiaca aguda	ENFERMEDAD	insuficiencia cardiaca aguda
crisis epileptica	crisis epileptica	ENFERMEDAD	crisis epileptica
2016	2016	FECHAS	2016
traqueostomia	traqueostomia	PROCEDIMIENTO	traqueostomia
buen estado general	buen estado general	SINTOMA	buen estado general
quetiapina	quetiapina	FARMACO	quetiapina
interferon (farmaco)	interferon	FARMACO	interferon
inflamacion general	inflamacion general	SINTOMA	inflamacion general
afasia anomica (enfermedad)	afasia anomica	ENFERMEDAD	afasia anomica
febricula	febricula	SINTOMA	febricula
antineutrofilicos sericos	antineutrofilicos sericos	ENTIDAD-OBSERVABLE	antineutrofilicos sericos
alteracion sistolica del ventriculo	alteracion sistolica del ventriculo	SINTOMA	alteracion sistolica del ventriculo
esplenectomia	esplenectomia	PROCEDIMIENTO	esplenectomia
78 anos	78 anos	EDAD-SUJETO-ASISTENCIA	78 anos
insuficiencia cardiaca congestiva	insuficiencia cardiaca congestiva	ENFERMEDAD	insuficiencia cardiaca congestiva
hematuria (sintoma)	hematuria	SINTOMA	hematuria
de brucella	de brucella	SPECIES	de brucella
anticuerpos de covid19	anticuerpos de covid19	PROTEINAS	anticuerpos de covid19
anticuerpos antinucleares (entidad-observable)	anticuerpos antinucleares	ENTIDAD-OBSERVABLE	anticuerpos antinucleares
fallecio (enfermedad)	fallecio	ENFERMEDAD	fallecio
hemocultivo	hemocultivo	PROCEDIMIENTO	hemocultivo
anticoagulante (farmaco)	anticoagulante	FARMACO	anticoagulante
neumonia virica	neumonia virica	ENFERMEDAD	neumonia virica
clostridum difficile	clostridum difficile	SPECIES	clostridum difficile
amplicilina	amplicilina	FARMACO	amplicilina
claritromicina	claritromicina	FARMACO	claritromicina
sintomas gastrointestinales	sintomas gastrointestinales	SINTOMA	sintomas gastrointestinales
administracion continua de fenobarbital	administracion continua de fenobarbital	PROCEDIMIENTO	administracion continua de fenobarbital
evaluacion de las extremidades inferiores	evaluacion de las extremidades inferiores	PROCEDIMIENTO	evaluacion de las extremidades inferiores
hidroxicloroquina (farmaco)	hidroxicloroquina	FARMACO	hidroxicloroquina
infeccion	infeccion	ENFERMEDAD	infeccion
il6	il6	PROTEINAS	il6
25 de marzo de 2020	25 de marzo de 2020	FECHAS	25 de marzo de 2020
SMX	SMX	FARMACO	SMX
clostridium difficile	clostridium difficile	SPECIES	clostridium difficile
aortitis autoinmunitaria de la aorta abdominal	aortitis autoinmunitaria de la aorta abdominal	ENFERMEDAD	aortitis autoinmunitaria de la aorta abdominal
68 anos	68 anos	EDAD-SUJETO-ASISTENCIA	68 anos
alteracion de las funciones ejecutivas	alteracion de las funciones ejecutivas	SINTOMA	alteracion de las funciones ejecutivas
risperidona	risperidona	FARMACO	risperidona
cefepime	cefepime	FARMACO	cefepime
estado epileptico resistente	estado epileptico resistente	ENFERMEDAD	estado epileptico resistente
citometria de flujo	citometria de flujo	PROCEDIMIENTO	citometria de flujo
ageusia	ageusia	SINTOMA	ageusia
erupcion de placas eritematosas pruriginosas extendidas	erupcion de placas eritematosas pruriginosas extendidas	SINTOMA	erupcion de placas eritematosas pruriginosas extendidas
dialisis local de utah	dialisis local de utah	PROCEDIMIENTO	dialisis local de utah
delirio confusional (enfermedad)	delirio confusional	ENFERMEDAD	delirio confusional
prueba de troponina I	prueba de troponina I	PROCEDIMIENTO	prueba de troponina I
sdra	sdra	ENFERMEDAD	sdra
dermatosis exfoliativa	dermatosis exfoliativa	ENFERMEDAD	dermatosis exfoliativa
leucocitosis (sintoma)	leucocitosis	SINTOMA	leucocitosis
crepitantes debiles	crepitantes debiles	SINTOMA	crepitantes debiles
aumento de la LDH	aumento de la LDH	SINTOMA	aumento de la LDH
inmunoglobulina G	inmunoglobulina G	PROTEINAS	inmunoglobulina G
aumento de tamano	aumento de tamano	SINTOMA	aumento de tamano
frotis faringeos	frotis faringeos	PROCEDIMIENTO	frotis faringeos
angiotomografia craneomaxilofacial	angiotomografia craneomaxilofacial	PROCEDIMIENTO	angiotomografia craneomaxilofacial
CMV	CMV	SPECIES	CMV
metaneumovirus humano	metaneumovirus humano	SPECIES	metaneumovirus humano
debilidad general	debilidad general	SINTOMA	debilidad general
caida de la saturacion de oxigeno	caida de la saturacion de oxigeno	SINTOMA	caida de la saturacion de oxigeno
rickettsia	rickettsia	SPECIES	rickettsia
espiramicina	espiramicina	FARMACO	espiramicina
ntprobnp	ntprobnp	ENTIDAD-OBSERVABLE	ntprobnp
insuficiencia respiratoria grave	insuficiencia respiratoria grave	ENFERMEDAD	insuficiencia respiratoria grave
creatinina serica	creatinina serica	ENTIDAD-OBSERVABLE	creatinina serica
sibilancias	sibilancias	SINTOMA	sibilancias
dimero D (entidad-observable)	dimero D	ENTIDAD-OBSERVABLE	dimero D
interleucina (entidad-observable)	interleucina	ENTIDAD-OBSERVABLE	interleucina
retiraron los antibioticos	retiraron los antibioticos	PROCEDIMIENTO	retiraron los antibioticos
pruebas microbiologicas de LCR	pruebas microbiologicas de LCR	PROCEDIMIENTO	pruebas microbiologicas de LCR
consolidacion en parte del lobulo inferior del pulmon	consolidacion en parte del lobulo inferior del pulmon	ENFERMEDAD	consolidacion en parte del lobulo inferior del pulmon
baja saturacion de oxigeno	baja saturacion de oxigeno	SINTOMA	baja saturacion de oxigeno
exantema generalizado morbiliforme en el tronco y las extremidades	exantema generalizado morbiliforme en el tronco y las extremidades	SINTOMA	exantema generalizado morbiliforme en el tronco y las extremidades
linfoadenopatia cervical	linfoadenopatia cervical	ENFERMEDAD	linfoadenopatia cervical
osteoporosis	osteoporosis	ENFERMEDAD	osteoporosis
anomalia intracraneal aguda	anomalia intracraneal aguda	ENFERMEDAD	anomalia intracraneal aguda
15g	15g	FARMACO	15g
1 de enero de 2020	1 de enero de 2020	FECHAS	1 de enero de 2020
signo de babinski	signo de babinski	SINTOMA	signo de babinski
crepitantes en la parte inferior del pulmon	crepitantes en la parte inferior del pulmon	SINTOMA	crepitantes en la parte inferior del pulmon
infecciones nosocomiales	infecciones nosocomiales	ENFERMEDAD	infecciones nosocomiales
debilidad generalizada	debilidad generalizada	SINTOMA	debilidad generalizada
oxigenoterapia mediante canula nasal	oxigenoterapia mediante canula nasal	PROCEDIMIENTO	oxigenoterapia mediante canula nasal
gadolinio	gadolinio	FARMACO	gadolinio
15 de abril	15 de abril	FECHAS	15 de abril
ferritina (entidad-observable)	ferritina	ENTIDAD-OBSERVABLE	ferritina
antihipertensivos (farmaco)	antihipertensivos	FARMACO	antihipertensivos
eritema que empeoraba progresivamente en el pulgar y en el cuarto dedo de la mano	eritema que empeoraba progresivamente en el pulgar y en el cuarto dedo de la mano	SINTOMA	eritema que empeoraba progresivamente en el pulgar y en el cuarto dedo de la mano
alteraciones isquemicas en la region irrigada por la arteria cerebral	alteraciones isquemicas en la region irrigada por la arteria cerebral	ENFERMEDAD	alteraciones isquemicas en la region irrigada por la arteria cerebral
asma leve intermitente	asma leve intermitente	ENFERMEDAD	asma leve intermitente
11 anos	11 anos	EDAD-SUJETO-ASISTENCIA	11 anos
13 de mayo de 2020	13 de mayo de 2020	FECHAS	13 de mayo de 2020
tirol del Sur	tirol del Sur	TERRITORIO	tirol del Sur
infarto agudo	infarto agudo	ENFERMEDAD	infarto agudo
midazolam	midazolam	FARMACO	midazolam
insuficiencia respiratoria hipoxemica	insuficiencia respiratoria hipoxemica	ENFERMEDAD	insuficiencia respiratoria hipoxemica
hiperleucocitosis	hiperleucocitosis	ENFERMEDAD	hiperleucocitosis
drenaje toracico	drenaje toracico	PROCEDIMIENTO	drenaje toracico
rehabilitacion de covid19	rehabilitacion de covid19	PROCEDIMIENTO	rehabilitacion de covid19
infeccion bacteriana	infeccion bacteriana	ENFERMEDAD	infeccion bacteriana
frotis nasofaringeo para sarscov2	frotis nasofaringeo para sarscov2	PROCEDIMIENTO	frotis nasofaringeo para sarscov2
desmielinizacion periferica	desmielinizacion periferica	ENFERMEDAD	desmielinizacion periferica
tension arterial	tension arterial	ENTIDAD-OBSERVABLE	tension arterial
dabigatran	dabigatran	FARMACO	dabigatran
kaletra	kaletra	FARMACO	kaletra
administracion de heparina de bajo peso molecular	administracion de heparina de bajo peso molecular	PROCEDIMIENTO	administracion de heparina de bajo peso molecular
cefalea frontal	cefalea frontal	SINTOMA	cefalea frontal
angiografia por TAC	angiografia por TAC	PROCEDIMIENTO	angiografia por TAC
BNP (proteinas)	BNP	PROTEINAS	BNP
abipenem	abipenem	PROTEINAS	abipenem
18 anos	18 anos	EDAD-SUJETO-ASISTENCIA	18 anos
pruebas de autoanticuerpos y de virus cardiotropicos	pruebas de autoanticuerpos y de virus cardiotropicos	PROCEDIMIENTO	pruebas de autoanticuerpos y de virus cardiotropicos
nefropatia cronica	nefropatia cronica	ENFERMEDAD	nefropatia cronica
anomalias electroliticas	anomalias electroliticas	ENFERMEDAD	anomalias electroliticas
absceso de las glandulas salivales y neoplasia	absceso de las glandulas salivales y neoplasia	ENFERMEDAD	absceso de las glandulas salivales y neoplasia
muerte	muerte	ENFERMEDAD	muerte
hospital provincial de hunan	hospital provincial de hunan	HOSPITAL	hospital provincial de hunan
PCR para sarscov2 fue positiva	PCR para sarscov2 fue positiva	SINTOMA	PCR para sarscov2 fue positiva
infeccion respiratoria	infeccion respiratoria	ENFERMEDAD	infeccion respiratoria
tocilizumab (proteinas)	tocilizumab	PROTEINAS	tocilizumab
debilidad en ambas piernas	debilidad en ambas piernas	SINTOMA	debilidad en ambas piernas
analisis de liquido cefalorraquideo	analisis de liquido cefalorraquideo	PROCEDIMIENTO	analisis de liquido cefalorraquideo
sindrome coronario agudo	sindrome coronario agudo	ENFERMEDAD	sindrome coronario agudo
covid19 subclinica	covid19 subclinica	ENFERMEDAD	covid19 subclinica
insulina (farmaco)	insulina	FARMACO	insulina
virus de la gripe	virus de la gripe	SPECIES	virus de la gripe
TnI (entidad-observable)	TnI	ENTIDAD-OBSERVABLE	TnI
anticuerpos IgM	anticuerpos IgM	ENTIDAD-OBSERVABLE	anticuerpos IgM
biopsia	biopsia	PROCEDIMIENTO	biopsia
absceso pulmonar diametro interno 43 mm en el lobulo inferior	absceso pulmonar diametro interno 43 mm en el lobulo inferior	ENFERMEDAD	absceso pulmonar diametro interno 43 mm en el lobulo inferior
bilirrubina total	bilirrubina total	ENTIDAD-OBSERVABLE	bilirrubina total
eltrombopag	eltrombopag	FARMACO	eltrombopag
crepitantes en el pulmon derecho	crepitantes en el pulmon derecho	SINTOMA	crepitantes en el pulmon derecho
taquicardia (sintoma)	taquicardia	SINTOMA	taquicardia
cefalea	cefalea	SINTOMA	cefalea
broncoscopia	broncoscopia	PROCEDIMIENTO	broncoscopia
400mg100	400mg100	FARMACO	400mg100
tratada con corticoesteroides	tratada con corticoesteroides	PROCEDIMIENTO	tratada con corticoesteroides
corticoesteroides (procedimiento)	corticoesteroides	PROCEDIMIENTO	corticoesteroides
oxitocina	oxitocina	FARMACO	oxitocina
metoprolol	metoprolol	FARMACO	metoprolol
bronquiolitis adenovirica	bronquiolitis adenovirica	ENFERMEDAD	bronquiolitis adenovirica
leucocitosis (enfermedad)	leucocitosis	ENFERMEDAD	leucocitosis
PCR del LCR para deteccion de sarscov2 fue negativa	PCR del LCR para deteccion de sarscov2 fue negativa	SINTOMA	PCR del LCR para deteccion de sarscov2 fue negativa
troponina cardiaca	troponina cardiaca	ENTIDAD-OBSERVABLE	troponina cardiaca
antihipertensivos (procedimiento)	antihipertensivos	PROCEDIMIENTO	antihipertensivos
bisoprolol	bisoprolol	FARMACO	bisoprolol
abrasion del labio inferior (enfermedad)	abrasion del labio inferior	ENFERMEDAD	abrasion del labio inferior
antiinflamatorios no esteroideos (farmaco)	antiinflamatorios no esteroideos	FARMACO	antiinflamatorios no esteroideos
cuarenta anos	cuarenta anos	EDAD-SUJETO-ASISTENCIA	cuarenta anos
hidratacion iv	hidratacion iv	PROCEDIMIENTO	hidratacion iv
chlamydia	chlamydia	SPECIES	chlamydia
leucocitopenia (sintoma)	leucocitopenia	SINTOMA	leucocitopenia
descenso del segmento ST en v2v4	descenso del segmento ST en v2v4	SINTOMA	descenso del segmento ST en v2v4
mareos	mareos	SINTOMA	mareos
timosina	timosina	FARMACO	timosina
saturacion de oxigeno arterial	saturacion de oxigeno arterial	ENTIDAD-OBSERVABLE	saturacion de oxigeno arterial
dimerod	dimerod	PROTEINAS	dimerod
insomnio (enfermedad)	insomnio	ENFERMEDAD	insomnio
administro oxigeno y antibioticos	administro oxigeno y antibioticos	PROCEDIMIENTO	administro oxigeno y antibioticos
ventilacion asistida	ventilacion asistida	PROCEDIMIENTO	ventilacion asistida
alaninaaminotransferasa (entidad-observable)	alaninaaminotransferasa	ENTIDAD-OBSERVABLE	alaninaaminotransferasa
interferon beta (proteinas)	interferon beta	PROTEINAS	interferon beta
hipertension arterial	hipertension arterial	ENFERMEDAD	hipertension arterial
antiinflamatorios no esteroideos (procedimiento)	antiinflamatorios no esteroideos	PROCEDIMIENTO	antiinflamatorios no esteroideos
polipnea	polipnea	SINTOMA	polipnea
moxifloxacina	moxifloxacina	FARMACO	moxifloxacina
aumento de interleucina	aumento de interleucina	SINTOMA	aumento de interleucina
francia	francia	PAIS	francia
crepitantes bilaterales	crepitantes bilaterales	SINTOMA	crepitantes bilaterales
atelectasia por compresion	atelectasia por compresion	ENFERMEDAD	atelectasia por compresion
anemia normocitica leve	anemia normocitica leve	ENFERMEDAD	anemia normocitica leve
hipertension sistemica	hipertension sistemica	ENFERMEDAD	hipertension sistemica
estridor	estridor	SINTOMA	estridor
confusion e inquietud	confusion e inquietud	SINTOMA	confusion e inquietud
P jirovecii	P jirovecii	SPECIES	P jirovecii
RMI	RMI	PROCEDIMIENTO	RMI
frotis nasal	frotis nasal	PROCEDIMIENTO	frotis nasal
alteraciones del sueno	alteraciones del sueno	SINTOMA	alteraciones del sueno
madrid	madrid	TERRITORIO	madrid
ateroesclerosis	ateroesclerosis	ENFERMEDAD	ateroesclerosis
alaninatransaminasa (entidad-observable)	alaninatransaminasa	ENTIDAD-OBSERVABLE	alaninatransaminasa
cistectomia transuretral	cistectomia transuretral	PROCEDIMIENTO	cistectomia transuretral
SGB asociado a covid19	SGB asociado a covid19	ENFERMEDAD	SGB asociado a covid19
14 anos	14 anos	EDAD-SUJETO-ASISTENCIA	14 anos
amlodipina	amlodipina	FARMACO	amlodipina
troponina T	troponina T	PROTEINAS	troponina T
11 de febrero	11 de febrero	FECHAS	11 de febrero
hospital universitario de amiens	hospital universitario de amiens	HOSPITAL	hospital universitario de amiens
dificultad creciente para respirar	dificultad creciente para respirar	SINTOMA	dificultad creciente para respirar
aumento de leucocitos	aumento de leucocitos	SINTOMA	aumento de leucocitos
abril de 2020	abril de 2020	FECHAS	abril de 2020
aislamiento domiciliario	aislamiento domiciliario	PROCEDIMIENTO	aislamiento domiciliario
RMN cardiaca	RMN cardiaca	PROCEDIMIENTO	RMN cardiaca
hemoglobina (entidad-observable)	hemoglobina	ENTIDAD-OBSERVABLE	hemoglobina
paro cardiaco mortal	paro cardiaco mortal	ENFERMEDAD	paro cardiaco mortal
72 anos	72 anos	EDAD-SUJETO-ASISTENCIA	72 anos
diabetes	diabetes	ENFERMEDAD	diabetes
ecografia toracica	ecografia toracica	PROCEDIMIENTO	ecografia toracica
opresion toracica	opresion toracica	SINTOMA	opresion toracica
microtrombos pulmonares	microtrombos pulmonares	ENFERMEDAD	microtrombos pulmonares
asma infantil	asma infantil	ENFERMEDAD	asma infantil
protrombina	protrombina	PROTEINAS	protrombina
50 anos	50 anos	EDAD-SUJETO-ASISTENCIA	50 anos
urocultivos	urocultivos	PROCEDIMIENTO	urocultivos
sindrome respiratorio agudo grave por coronavirus 2	sindrome respiratorio agudo grave por coronavirus 2	ENFERMEDAD	sindrome respiratorio agudo grave por coronavirus 2
cultivos de esputo	cultivos de esputo	PROCEDIMIENTO	cultivos de esputo
infeccion cronica	infeccion cronica	ENFERMEDAD	infeccion cronica
asma leve	asma leve	ENFERMEDAD	asma leve
signo de lasegue	signo de lasegue	SINTOMA	signo de lasegue
exantema cutaneo	exantema cutaneo	SINTOMA	exantema cutaneo
clopidogrel	clopidogrel	FARMACO	clopidogrel
1 de abril	1 de abril	FECHAS	1 de abril
aumento de la demanda de oxigeno	aumento de la demanda de oxigeno	SINTOMA	aumento de la demanda de oxigeno
parestesia	parestesia	SINTOMA	parestesia
cd4cd8	cd4cd8	PROTEINAS	cd4cd8
pao2	pao2	ENTIDAD-OBSERVABLE	pao2
complemento	complemento	PROTEINAS	complemento
liberacion	liberacion	PROTEINAS	liberacion
53 anos	53 anos	EDAD-SUJETO-ASISTENCIA	53 anos
alaninoaminotransferasa (proteinas)	alaninoaminotransferasa	PROTEINAS	alaninoaminotransferasa
TAC toracicas de la madre	TAC toracicas de la madre	PROCEDIMIENTO	TAC toracicas de la madre
TAC toracica y abdominal	TAC toracica y abdominal	PROCEDIMIENTO	TAC toracica y abdominal
hepatomegalia (enfermedad)	hepatomegalia	ENFERMEDAD	hepatomegalia
dolor en la region abdominal inferior	dolor en la region abdominal inferior	SINTOMA	dolor en la region abdominal inferior
aspartatoaminotransferasa (entidad-observable)	aspartatoaminotransferasa	ENTIDAD-OBSERVABLE	aspartatoaminotransferasa
neumonia atipica	neumonia atipica	ENFERMEDAD	neumonia atipica
alteracion de coagulacion	alteracion de coagulacion	SINTOMA	alteracion de coagulacion
parvovirus B19	parvovirus B19	SPECIES	parvovirus B19
transaminasas	transaminasas	PROTEINAS	transaminasas
neurologica	neurologica	PROCEDIMIENTO	neurologica
septiembre de 2015	septiembre de 2015	FECHAS	septiembre de 2015
hemorragia en el segmento apicoposterior del lobulo superior	hemorragia en el segmento apicoposterior del lobulo superior	ENFERMEDAD	hemorragia en el segmento apicoposterior del lobulo superior
interferon 1b (proteinas)	interferon 1b	PROTEINAS	interferon 1b
presion sistolica	presion sistolica	ENTIDAD-OBSERVABLE	presion sistolica
opacidades de vidrio esmerilado en ambos pulmones	opacidades de vidrio esmerilado en ambos pulmones	ENFERMEDAD	opacidades de vidrio esmerilado en ambos pulmones
infiltrados alveolares	infiltrados alveolares	SINTOMA	infiltrados alveolares
enfermedad mieloproliferativa	enfermedad mieloproliferativa	ENFERMEDAD	enfermedad mieloproliferativa
atelectasia subsegmentaria	atelectasia subsegmentaria	ENFERMEDAD	atelectasia subsegmentaria
embarazos	embarazos	ENFERMEDAD	embarazos
BNP (entidad-observable)	BNP	ENTIDAD-OBSERVABLE	BNP
ambroxol	ambroxol	FARMACO	ambroxol
exploracion cardiaca	exploracion cardiaca	PROCEDIMIENTO	exploracion cardiaca
despertable	despertable	SINTOMA	despertable
51 anos	51 anos	EDAD-SUJETO-ASISTENCIA	51 anos
sobreinfeccion por neumocistos	sobreinfeccion por neumocistos	ENFERMEDAD	sobreinfeccion por neumocistos
estertores inspiratorios basales	estertores inspiratorios basales	SINTOMA	estertores inspiratorios basales
sintomas paragripales	sintomas paragripales	SINTOMA	sintomas paragripales
amoxicilina	amoxicilina	FARMACO	amoxicilina
gestacion	gestacion	ENFERMEDAD	gestacion
glucorraquia	glucorraquia	FARMACO	glucorraquia
10 de enero de 2020	10 de enero de 2020	FECHAS	10 de enero de 2020
inmunofluorescencia indirecta	inmunofluorescencia indirecta	PROCEDIMIENTO	inmunofluorescencia indirecta
anticuerpos antiglucolipidicos	anticuerpos antiglucolipidicos	PROTEINAS	anticuerpos antiglucolipidicos
prueba de frotis nasofaringeo	prueba de frotis nasofaringeo	PROCEDIMIENTO	prueba de frotis nasofaringeo
66 anos	66 anos	EDAD-SUJETO-ASISTENCIA	66 anos
lesion isquemica	lesion isquemica	ENFERMEDAD	lesion isquemica
linezolid	linezolid	FARMACO	linezolid
atrofia muscular difusa	atrofia muscular difusa	ENFERMEDAD	atrofia muscular difusa
insuficiencia respiratoria hipoxica	insuficiencia respiratoria hipoxica	ENFERMEDAD	insuficiencia respiratoria hipoxica
prohormona nterminal	prohormona nterminal	PROTEINAS	prohormona nterminal
TAC toracicas abdominal y pelvica con contraste	TAC toracicas abdominal y pelvica con contraste	PROCEDIMIENTO	TAC toracicas abdominal y pelvica con contraste
falta de apetito	falta de apetito	SINTOMA	falta de apetito
eritema	eritema	SINTOMA	eritema
alteracion del estado mental	alteracion del estado mental	SINTOMA	alteracion del estado mental
creatina	creatina	FARMACO	creatina
sudoracion intensa	sudoracion intensa	SINTOMA	sudoracion intensa
capacidad hepatica	capacidad hepatica	ENTIDAD-OBSERVABLE	capacidad hepatica
carga virica	carga virica	ENTIDAD-OBSERVABLE	carga virica
oxigeno (procedimiento)	oxigeno	PROCEDIMIENTO	oxigeno
hiposmia (sintoma)	hiposmia	SINTOMA	hiposmia
orientado	orientado	SINTOMA	orientado
TAC craneal	TAC craneal	PROCEDIMIENTO	TAC craneal
mialgia (sintoma)	mialgia	SINTOMA	mialgia
ecografia doppler	ecografia doppler	PROCEDIMIENTO	ecografia doppler
amilasa	amilasa	PROTEINAS	amilasa
94 anos	94 anos	EDAD-SUJETO-ASISTENCIA	94 anos
parto (procedimiento)	parto	PROCEDIMIENTO	parto
fatiga	fatiga	SINTOMA	fatiga
anorexia	anorexia	SINTOMA	anorexia
hemofagocitosis	hemofagocitosis	ENFERMEDAD	hemofagocitosis
fosfocinasa	fosfocinasa	PROTEINAS	fosfocinasa
angiografia por resonancia magnetica	angiografia por resonancia magnetica	PROCEDIMIENTO	angiografia por resonancia magnetica
reconstruccion 3D frontal mediante ARM de las arterias supraaorticas	reconstruccion 3D frontal mediante ARM de las arterias supraaorticas	PROCEDIMIENTO	reconstruccion 3D frontal mediante ARM de las arterias supraaorticas
analisis completo autoinmunitario	analisis completo autoinmunitario	PROCEDIMIENTO	analisis completo autoinmunitario
abdomen estaba tenso	abdomen estaba tenso	SINTOMA	abdomen estaba tenso
disnea de esfuerzo	disnea de esfuerzo	SINTOMA	disnea de esfuerzo
enoxaparina	enoxaparina	FARMACO	enoxaparina
hemiparesia izquierda	hemiparesia izquierda	ENFERMEDAD	hemiparesia izquierda
hipotonia	hipotonia	SINTOMA	hipotonia
ECA	ECA	FARMACO	ECA
irritacion de garganta	irritacion de garganta	SINTOMA	irritacion de garganta
TAC pulmonar	TAC pulmonar	PROCEDIMIENTO	TAC pulmonar
altas dosis de vasopresores	altas dosis de vasopresores	PROCEDIMIENTO	altas dosis de vasopresores
analisis serologico	analisis serologico	PROCEDIMIENTO	analisis serologico
parto vaginal (enfermedad)	parto vaginal	ENFERMEDAD	parto vaginal
insuficiencia respiratoria hipoxemica aguda	insuficiencia respiratoria hipoxemica aguda	ENFERMEDAD	insuficiencia respiratoria hipoxemica aguda
37 anos	37 anos	EDAD-SUJETO-ASISTENCIA	37 anos
antigeno A	antigeno A	PROTEINAS	antigeno A
30 de enero	30 de enero	FECHAS	30 de enero
retraccion intercostal	retraccion intercostal	SINTOMA	retraccion intercostal
anosmia (enfermedad)	anosmia	ENFERMEDAD	anosmia
miopericarditis aguda	miopericarditis aguda	ENFERMEDAD	miopericarditis aguda
auscultacion cardiopulmonar	auscultacion cardiopulmonar	PROCEDIMIENTO	auscultacion cardiopulmonar
disfuncion ventricular	disfuncion ventricular	ENFERMEDAD	disfuncion ventricular
desgarro vesical	desgarro vesical	ENFERMEDAD	desgarro vesical
acidosis respiratoria	acidosis respiratoria	ENFERMEDAD	acidosis respiratoria
obesidad	obesidad	ENFERMEDAD	obesidad
duplicidad renal	duplicidad renal	ENFERMEDAD	duplicidad renal
trasplante cardiaco	trasplante cardiaco	PROCEDIMIENTO	trasplante cardiaco
interferon beta 12	interferon beta 12	PROTEINAS	interferon beta 12
aumento de fibrinogeno dimero D y proteina creactiva	aumento de fibrinogeno dimero D y proteina creactiva	SINTOMA	aumento de fibrinogeno dimero D y proteina creactiva
arreflexia generalizada	arreflexia generalizada	SINTOMA	arreflexia generalizada
edema miocardico difuso	edema miocardico difuso	SINTOMA	edema miocardico difuso
angina vasoespastica	angina vasoespastica	ENFERMEDAD	angina vasoespastica
aumento de creatinina	aumento de creatinina	SINTOMA	aumento de creatinina
estudios de conduccion nerviosa	estudios de conduccion nerviosa	PROCEDIMIENTO	estudios de conduccion nerviosa
acumulacion de liquido libre en la zona paracolica derecha y pelvica	acumulacion de liquido libre en la zona paracolica derecha y pelvica	SINTOMA	acumulacion de liquido libre en la zona paracolica derecha y pelvica
tratamiento con metilprednisolona	tratamiento con metilprednisolona	PROCEDIMIENTO	tratamiento con metilprednisolona
IgA	IgA	PROTEINAS	IgA
antibiotico	antibiotico	PROCEDIMIENTO	antibiotico
desplazamiento a wuhan	desplazamiento a wuhan	SINTOMA	desplazamiento a wuhan
gen S	gen S	PROTEINAS	gen S
5 meses	5 meses	EDAD-SUJETO-ASISTENCIA	5 meses
antigenos treponemicos	antigenos treponemicos	PROTEINAS	antigenos treponemicos
exploracion toracica	exploracion toracica	PROCEDIMIENTO	exploracion toracica
opacidades alveolares bilaterales multifocales con atelectasia en la zona inferior del pulmon	opacidades alveolares bilaterales multifocales con atelectasia en la zona inferior del pulmon	ENFERMEDAD	opacidades alveolares bilaterales multifocales con atelectasia en la zona inferior del pulmon
pulsioximetria	pulsioximetria	PROCEDIMIENTO	pulsioximetria
esclerosis multiple	esclerosis multiple	ENFERMEDAD	esclerosis multiple
ausencia de reflejos osteotendinosos	ausencia de reflejos osteotendinosos	SINTOMA	ausencia de reflejos osteotendinosos
inmunodeficiencias hereditarias	inmunodeficiencias hereditarias	ENFERMEDAD	inmunodeficiencias hereditarias
estertores bibasales	estertores bibasales	SINTOMA	estertores bibasales
prueba de sarscov2 mediante rtpcr	prueba de sarscov2 mediante rtpcr	PROCEDIMIENTO	prueba de sarscov2 mediante rtpcr
electrocardiograficos	electrocardiograficos	PROCEDIMIENTO	electrocardiograficos
dificultad respiratoria	dificultad respiratoria	SINTOMA	dificultad respiratoria
capacidad funcional renal	capacidad funcional renal	ENTIDAD-OBSERVABLE	capacidad funcional renal
acetaminofeno	acetaminofeno	FARMACO	acetaminofeno
25 de febrero	25 de febrero	FECHAS	25 de febrero
artralgias	artralgias	SINTOMA	artralgias
chlamydia pneumoniae	chlamydia pneumoniae	SPECIES	chlamydia pneumoniae
miligramo	miligramo	FARMACO	miligramo
analisis de ttpa	analisis de ttpa	PROCEDIMIENTO	analisis de ttpa
caballo	caballo	SPECIES	caballo
albumina301	albumina301	FARMACO	albumina301
hepatitis abc treponema pallidum y VIH	hepatitis abc treponema pallidum y VIH	ENFERMEDAD	hepatitis abc treponema pallidum y VIH
carbono	carbono	FARMACO	carbono
aminotransferasa (proteinas)	aminotransferasa	PROTEINAS	aminotransferasa
etambutol	etambutol	FARMACO	etambutol
disminucion de los movimientos fetales	disminucion de los movimientos fetales	SINTOMA	disminucion de los movimientos fetales
PCR (entidad-observable)	PCR	ENTIDAD-OBSERVABLE	PCR
ventilacion mecanica no invasiva	ventilacion mecanica no invasiva	PROCEDIMIENTO	ventilacion mecanica no invasiva
pruebas analiticas del LCR	pruebas analiticas del LCR	PROCEDIMIENTO	pruebas analiticas del LCR
rigidez	rigidez	SINTOMA	rigidez
decilitro	decilitro	FARMACO	decilitro
25 anos	25 anos	EDAD-SUJETO-ASISTENCIA	25 anos
esteroides (procedimiento)	esteroides	PROCEDIMIENTO	esteroides
insuficiencia circulatoria	insuficiencia circulatoria	ENFERMEDAD	insuficiencia circulatoria
saturacion de oxigeno normal en aire ambiental	saturacion de oxigeno normal en aire ambiental	SINTOMA	saturacion de oxigeno normal en aire ambiental
estado epileptico	estado epileptico	ENFERMEDAD	estado epileptico
gasometria arterial (entidad-observable)	gasometria arterial	ENTIDAD-OBSERVABLE	gasometria arterial
25 de marzo	25 de marzo	FECHAS	25 de marzo
aspirado medular	aspirado medular	PROCEDIMIENTO	aspirado medular
lloro excesivo	lloro excesivo	SINTOMA	lloro excesivo
hipoxemia (sintoma)	hipoxemia	SINTOMA	hipoxemia
aine (procedimiento)	aine	PROCEDIMIENTO	aine
cansancio	cansancio	SINTOMA	cansancio
interferon alfa2b (farmaco)	interferon alfa2b	FARMACO	interferon alfa2b
funcion ventricular	funcion ventricular	ENTIDAD-OBSERVABLE	funcion ventricular
velocidad de filtracion	velocidad de filtracion	ENTIDAD-OBSERVABLE	velocidad de filtracion
tos productiva	tos productiva	SINTOMA	tos productiva
daegu	daegu	TERRITORIO	daegu
troponinai (proteinas)	troponinai	PROTEINAS	troponinai
hipotension (enfermedad)	hipotension	ENFERMEDAD	hipotension
28 de febrero de 2020	28 de febrero de 2020	FECHAS	28 de febrero de 2020
PCR en exudado nasofaringeo	PCR en exudado nasofaringeo	PROCEDIMIENTO	PCR en exudado nasofaringeo
dolor	dolor	SINTOMA	dolor
hemocultivos	hemocultivos	PROCEDIMIENTO	hemocultivos
sulfametoxazol	sulfametoxazol	FARMACO	sulfametoxazol
interferon beta 1a (farmaco)	interferon beta 1a	FARMACO	interferon beta 1a
tabaquismo (sintoma)	tabaquismo	SINTOMA	tabaquismo
insulina glargina (proteinas)	insulina glargina	PROTEINAS	insulina glargina
12 de febrero de 2020	12 de febrero de 2020	FECHAS	12 de febrero de 2020
carcinoma renal sarcomatoide de celulas claras metastasico	carcinoma renal sarcomatoide de celulas claras metastasico	ENFERMEDAD	carcinoma renal sarcomatoide de celulas claras metastasico
colecistectomia	colecistectomia	PROCEDIMIENTO	colecistectomia
cultivos de orina y esputo	cultivos de orina y esputo	PROCEDIMIENTO	cultivos de orina y esputo
esputo parduzco	esputo parduzco	SINTOMA	esputo parduzco
opacidades pulmonares	opacidades pulmonares	ENFERMEDAD	opacidades pulmonares
GOT	GOT	PROTEINAS	GOT
legionella pneumophila	legionella pneumophila	SPECIES	legionella pneumophila
embarazo (enfermedad)	embarazo	ENFERMEDAD	embarazo
neumonia por covid19	neumonia por covid19	ENFERMEDAD	neumonia por covid19
insuficiencia multiorganica	insuficiencia multiorganica	ENFERMEDAD	insuficiencia multiorganica
29 de febrero	29 de febrero	FECHAS	29 de febrero
hipertermia	hipertermia	SINTOMA	hipertermia
afebril	afebril	SINTOMA	afebril
antibioticos betalactamicos intravenosos	antibioticos betalactamicos intravenosos	PROCEDIMIENTO	antibioticos betalactamicos intravenosos
derrame pleural en el torax	derrame pleural en el torax	ENFERMEDAD	derrame pleural en el torax
insuficiencia cardiaca	insuficiencia cardiaca	ENFERMEDAD	insuficiencia cardiaca
RMN	RMN	PROCEDIMIENTO	RMN
yiyang (enfermedad)	yiyang	ENFERMEDAD	yiyang
lavado broncoalveolar	lavado broncoalveolar	PROCEDIMIENTO	lavado broncoalveolar
hipoxemia grave	hipoxemia grave	ENFERMEDAD	hipoxemia grave
embolia pulmonar aguda	embolia pulmonar aguda	ENFERMEDAD	embolia pulmonar aguda
ALT (proteinas)	ALT	PROTEINAS	ALT
dobutamina	dobutamina	FARMACO	dobutamina
amoxicilinaacido clavulanico	amoxicilinaacido clavulanico	FARMACO	amoxicilinaacido clavulanico
ventilacion invasiva	ventilacion invasiva	PROCEDIMIENTO	ventilacion invasiva
46 anos	46 anos	EDAD-SUJETO-ASISTENCIA	46 anos
ERC	ERC	ENFERMEDAD	ERC
covid19 (sintoma)	covid19	SINTOMA	covid19
interferon 1b (farmaco)	interferon 1b	FARMACO	interferon 1b
brudzinski	brudzinski	SINTOMA	brudzinski
virus de la gripe B	virus de la gripe B	SPECIES	virus de la gripe B
clavulanato	clavulanato	FARMACO	clavulanato
8 de marzo	8 de marzo	FECHAS	8 de marzo
seroalbumina	seroalbumina	PROTEINAS	seroalbumina
bradicardia (sintoma)	bradicardia	SINTOMA	bradicardia
anticuerpos antimitocondriales (entidad-observable)	anticuerpos antimitocondriales	ENTIDAD-OBSERVABLE	anticuerpos antimitocondriales
TAC toracica	TAC toracica	PROCEDIMIENTO	TAC toracica
angiotomografia computarizada coronaria	angiotomografia computarizada coronaria	PROCEDIMIENTO	angiotomografia computarizada coronaria
diabetes mellitus	diabetes mellitus	ENFERMEDAD	diabetes mellitus
acidosis metabolica	acidosis metabolica	ENFERMEDAD	acidosis metabolica
interferon alfa2b (proteinas)	interferon alfa2b	PROTEINAS	interferon alfa2b
oxigenoterapia nasal	oxigenoterapia nasal	PROCEDIMIENTO	oxigenoterapia nasal
52 anos	52 anos	EDAD-SUJETO-ASISTENCIA	52 anos
alteraciones electroliticas	alteraciones electroliticas	SINTOMA	alteraciones electroliticas
frotis nasofaringeo y orofaringeo	frotis nasofaringeo y orofaringeo	PROCEDIMIENTO	frotis nasofaringeo y orofaringeo
arreflexia	arreflexia	SINTOMA	arreflexia
5 anos	5 anos	EDAD-SUJETO-ASISTENCIA	5 anos
sarscov2 mediante rtpcr	sarscov2 mediante rtpcr	PROTEINAS	sarscov2 mediante rtpcr
IgG de sarscov2	IgG de sarscov2	PROTEINAS	IgG de sarscov2
vitaminas	vitaminas	FARMACO	vitaminas
creatinafosfocinasa (entidad-observable)	creatinafosfocinasa	ENTIDAD-OBSERVABLE	creatinafosfocinasa
sarscov2 (enfermedad)	sarscov2	ENFERMEDAD	sarscov2
aumento significativo de proteina creactiva	aumento significativo de proteina creactiva	SINTOMA	aumento significativo de proteina creactiva
T citotoxicos	T citotoxicos	SINTOMA	T citotoxicos
76 anos	76 anos	EDAD-SUJETO-ASISTENCIA	76 anos
cultivos viricos de esputo y secreciones nasofaringeas	cultivos viricos de esputo y secreciones nasofaringeas	PROCEDIMIENTO	cultivos viricos de esputo y secreciones nasofaringeas
anestesia	anestesia	PROCEDIMIENTO	anestesia
sodio serico	sodio serico	ENTIDAD-OBSERVABLE	sodio serico
tiempo de protrombina	tiempo de protrombina	ENTIDAD-OBSERVABLE	tiempo de protrombina
asma	asma	ENFERMEDAD	asma
coinfecciones	coinfecciones	ENFERMEDAD	coinfecciones
crepitantes en el pulmon	crepitantes en el pulmon	SINTOMA	crepitantes en el pulmon
administro oxigeno	administro oxigeno	PROCEDIMIENTO	administro oxigeno
proteina creactiva (entidad-observable)	proteina creactiva	ENTIDAD-OBSERVABLE	proteina creactiva
TAC pulmonares	TAC pulmonares	PROCEDIMIENTO	TAC pulmonares
insuficiencia renal aguda	insuficiencia renal aguda	ENFERMEDAD	insuficiencia renal aguda
choque septico	choque septico	ENFERMEDAD	choque septico
83 anos	83 anos	EDAD-SUJETO-ASISTENCIA	83 anos
fio2	fio2	ENTIDAD-OBSERVABLE	fio2
disfuncion del ventriculo	disfuncion del ventriculo	ENFERMEDAD	disfuncion del ventriculo
dermatosis neutrofilica	dermatosis neutrofilica	ENFERMEDAD	dermatosis neutrofilica
adalimumab	adalimumab	FARMACO	adalimumab
analisis microbiologicos	analisis microbiologicos	PROCEDIMIENTO	analisis microbiologicos
coronavirus	coronavirus	SPECIES	coronavirus
anomalias microvasculares	anomalias microvasculares	ENFERMEDAD	anomalias microvasculares
ecografia pulmonar	ecografia pulmonar	PROCEDIMIENTO	ecografia pulmonar
etiologias bacterianas o viricas	etiologias bacterianas o viricas	ENFERMEDAD	etiologias bacterianas o viricas
glasgow	glasgow	ENTIDAD-OBSERVABLE	glasgow
anticoagulante (procedimiento)	anticoagulante	PROCEDIMIENTO	anticoagulante
adelgazamiento	adelgazamiento	SINTOMA	adelgazamiento
CD4	CD4	PROTEINAS	CD4
alucinaciones	alucinaciones	SINTOMA	alucinaciones
neumonia intersticial grave	neumonia intersticial grave	ENFERMEDAD	neumonia intersticial grave
anticuerpos antiadn	anticuerpos antiadn	PROTEINAS	anticuerpos antiadn
citocinas	citocinas	PROTEINAS	citocinas
debilidad en las extremidades inferiores	debilidad en las extremidades inferiores	SINTOMA	debilidad en las extremidades inferiores
hepatitis C y parvovirus B19	hepatitis C y parvovirus B19	ENFERMEDAD	hepatitis C y parvovirus B19
ecografias pulmonares	ecografias pulmonares	PROCEDIMIENTO	ecografias pulmonares
alteraciones inespecificas de la onda T	alteraciones inespecificas de la onda T	SINTOMA	alteraciones inespecificas de la onda T
15 anos	15 anos	EDAD-SUJETO-ASISTENCIA	15 anos
administraron antibioticos y antipireticos	administraron antibioticos y antipireticos	PROCEDIMIENTO	administraron antibioticos y antipireticos
arritmias	arritmias	ENFERMEDAD	arritmias
fisioterapia	fisioterapia	PROCEDIMIENTO	fisioterapia
acroisquemia persistente bilateral de las extremidades inferiores	acroisquemia persistente bilateral de las extremidades inferiores	SINTOMA	acroisquemia persistente bilateral de las extremidades inferiores
laparotomia	laparotomia	PROCEDIMIENTO	laparotomia
prueba de rtpcr	prueba de rtpcr	PROCEDIMIENTO	prueba de rtpcr
24 de marzo de 2020	24 de marzo de 2020	FECHAS	24 de marzo de 2020
insuficiencia respiratoria hipocapnica hipoxemica	insuficiencia respiratoria hipocapnica hipoxemica	ENFERMEDAD	insuficiencia respiratoria hipocapnica hipoxemica
anticuerpos citoplasmaticos	anticuerpos citoplasmaticos	ENTIDAD-OBSERVABLE	anticuerpos citoplasmaticos
1 de abril de 2020	1 de abril de 2020	FECHAS	1 de abril de 2020
21 de febrero	21 de febrero	FECHAS	21 de febrero
ampa12	ampa12	PROTEINAS	ampa12
anticuerpos antcd20	anticuerpos antcd20	PROTEINAS	anticuerpos antcd20
ANA (proteinas)	ANA	PROTEINAS	ANA
indice visual	indice visual	ENTIDAD-OBSERVABLE	indice visual
aumento del dimero D a 6120 ugl	aumento del dimero D a 6120 ugl	SINTOMA	aumento del dimero D a 6120 ugl
tos persistente	tos persistente	SINTOMA	tos persistente
epistaxis en las extremidades inferiores (enfermedad)	epistaxis en las extremidades inferiores	ENFERMEDAD	epistaxis en las extremidades inferiores
rtpcr (procedimiento)	rtpcr	PROCEDIMIENTO	rtpcr
respiracion asistida invasiva	respiracion asistida invasiva	PROCEDIMIENTO	respiracion asistida invasiva
mareo	mareo	SINTOMA	mareo
dolor epigastrico	dolor epigastrico	SINTOMA	dolor epigastrico
odinofagia	odinofagia	SINTOMA	odinofagia
intubado	intubado	PROCEDIMIENTO	intubado
trombocitosis	trombocitosis	ENFERMEDAD	trombocitosis
electroencefalograma	electroencefalograma	PROCEDIMIENTO	electroencefalograma
tuberculosis	tuberculosis	ENFERMEDAD	tuberculosis
esteroides oftalmicos	esteroides oftalmicos	PROCEDIMIENTO	esteroides oftalmicos
alergia a los frutos secos	alergia a los frutos secos	ENFERMEDAD	alergia a los frutos secos
hipoalbuminemia (enfermedad)	hipoalbuminemia	ENFERMEDAD	hipoalbuminemia
dolor de muelas	dolor de muelas	SINTOMA	dolor de muelas
infliximab (farmaco)	infliximab	FARMACO	infliximab
singapur	singapur	PAIS	singapur
ampicilina	ampicilina	FARMACO	ampicilina
benzonatato	benzonatato	FARMACO	benzonatato
sindrome de guillainbarre	sindrome de guillainbarre	ENFERMEDAD	sindrome de guillainbarre
clorhidrato de ambroxol	clorhidrato de ambroxol	FARMACO	clorhidrato de ambroxol
hbpm	hbpm	FARMACO	hbpm
5fluorouracil	5fluorouracil	FARMACO	5fluorouracil
covid19 (farmaco)	covid19	FARMACO	covid19
oxigeno arterial	oxigeno arterial	ENTIDAD-OBSERVABLE	oxigeno arterial
tacrolimus	tacrolimus	FARMACO	tacrolimus
exploracion neurologica	exploracion neurologica	PROCEDIMIENTO	exploracion neurologica
artromialgia generalizada	artromialgia generalizada	SINTOMA	artromialgia generalizada
anticoagulantes	anticoagulantes	PROCEDIMIENTO	anticoagulantes
antibiograma	antibiograma	PROCEDIMIENTO	antibiograma
35 anos	35 anos	EDAD-SUJETO-ASISTENCIA	35 anos
88 anos	88 anos	EDAD-SUJETO-ASISTENCIA	88 anos
pulso fetal	pulso fetal	ENTIDAD-OBSERVABLE	pulso fetal
lumbalgia	lumbalgia	SINTOMA	lumbalgia
nina	nina	SEXO-SUJETO-ASISTENCIA	nina
aptc de doble energia	aptc de doble energia	PROCEDIMIENTO	aptc de doble energia
tos seca	tos seca	SINTOMA	tos seca
hipertonia	hipertonia	SINTOMA	hipertonia
edema pulmonar (sintoma)	edema pulmonar	SINTOMA	edema pulmonar
hiperintensidad	hiperintensidad	FARMACO	hiperintensidad
piperacilinatazobactam	piperacilinatazobactam	FARMACO	piperacilinatazobactam
receptor de la interleucina 6	receptor de la interleucina 6	PROTEINAS	receptor de la interleucina 6
de coronavirus	de coronavirus	SPECIES	de coronavirus
coagulopatia	coagulopatia	ENFERMEDAD	coagulopatia
PCR de las heces	PCR de las heces	PROCEDIMIENTO	PCR de las heces
dolor en fosa lumbar	dolor en fosa lumbar	SINTOMA	dolor en fosa lumbar
aumento de leucocitos a 10800l con 9400 neutrofilosl	aumento de leucocitos a 10800l con 9400 neutrofilosl	SINTOMA	aumento de leucocitos a 10800l con 9400 neutrofilosl
56 anos	56 anos	EDAD-SUJETO-ASISTENCIA	56 anos
insuficiencia respiratoria	insuficiencia respiratoria	ENFERMEDAD	insuficiencia respiratoria
antidescarboxilasa65 del acido glutamico	antidescarboxilasa65 del acido glutamico	PROTEINAS	antidescarboxilasa65 del acido glutamico
microlitro	microlitro	PROTEINAS	microlitro
factor VII activado	factor VII activado	PROTEINAS	factor VII activado
nino	nino	SEXO-SUJETO-ASISTENCIA	nino
anestesia general	anestesia general	PROCEDIMIENTO	anestesia general
disfuncion esfinteriana	disfuncion esfinteriana	ENFERMEDAD	disfuncion esfinteriana
lesion renal aguda	lesion renal aguda	ENFERMEDAD	lesion renal aguda
disnea aguda (sintoma)	disnea aguda	SINTOMA	disnea aguda
PCT (entidad-observable)	PCT	ENTIDAD-OBSERVABLE	PCT
enfermedad pulmonar intersticial	enfermedad pulmonar intersticial	ENFERMEDAD	enfermedad pulmonar intersticial
intolerancia fetal (sintoma)	intolerancia fetal	SINTOMA	intolerancia fetal
apnea del sueno	apnea del sueno	ENFERMEDAD	apnea del sueno
taquicardia (enfermedad)	taquicardia	ENFERMEDAD	taquicardia
insuficiencia renal cronica	insuficiencia renal cronica	ENFERMEDAD	insuficiencia renal cronica
hioscina	hioscina	FARMACO	hioscina
probnp (proteinas)	probnp	PROTEINAS	probnp
trigliceridos	trigliceridos	FARMACO	trigliceridos
ipratropio	ipratropio	FARMACO	ipratropio
bocavirus	bocavirus	SPECIES	bocavirus
12 de abril de 2020	12 de abril de 2020	FECHAS	12 de abril de 2020
1 de febrero	1 de febrero	FECHAS	1 de febrero
paro cardiaco subito	paro cardiaco subito	ENFERMEDAD	paro cardiaco subito
hospital e prontosocorro delphina rinaldi abdel aziz	hospital e prontosocorro delphina rinaldi abdel aziz	HOSPITAL	hospital e prontosocorro delphina rinaldi abdel aziz
LDH (proteinas)	LDH	PROTEINAS	LDH
virus	virus	SPECIES	virus
fumador (sintoma)	fumador	SINTOMA	fumador
troponina (proteinas)	troponina	PROTEINAS	troponina
feto intrauterino	feto intrauterino	ENFERMEDAD	feto intrauterino
albumina (proteinas)	albumina	PROTEINAS	albumina
acidosis metabolica grave	acidosis metabolica grave	ENFERMEDAD	acidosis metabolica grave
anemico	anemico	SINTOMA	anemico
artropatia degenerativa cervical	artropatia degenerativa cervical	ENFERMEDAD	artropatia degenerativa cervical
HAA	HAA	ENFERMEDAD	HAA
doxiciclina	doxiciclina	FARMACO	doxiciclina
18 de enero	18 de enero	FECHAS	18 de enero
20 de marzo	20 de marzo	FECHAS	20 de marzo
exploracion	exploracion	PROCEDIMIENTO	exploracion
hemorragia alveolar difusa	hemorragia alveolar difusa	ENFERMEDAD	hemorragia alveolar difusa
hidroxicloroquina (proteinas)	hidroxicloroquina	PROTEINAS	hidroxicloroquina
sarcoidosis	sarcoidosis	ENFERMEDAD	sarcoidosis
alzheimer	alzheimer	ENFERMEDAD	alzheimer
corticoides (farmaco)	corticoides	FARMACO	corticoides
tiempo de tromboplastina	tiempo de tromboplastina	ENTIDAD-OBSERVABLE	tiempo de tromboplastina
receptor de il2 soluble	receptor de il2 soluble	PROTEINAS	receptor de il2 soluble
ciudad de wuhan	ciudad de wuhan	TERRITORIO	ciudad de wuhan
C3	C3	PROTEINAS	C3
ronchas	ronchas	SINTOMA	ronchas
cotrimoxazol	cotrimoxazol	FARMACO	cotrimoxazol
alimentacion nasogastrica	alimentacion nasogastrica	PROCEDIMIENTO	alimentacion nasogastrica
borrelia	borrelia	SPECIES	borrelia
frotis faringeo	frotis faringeo	PROCEDIMIENTO	frotis faringeo
prueba de ARN de sarscov2	prueba de ARN de sarscov2	PROCEDIMIENTO	prueba de ARN de sarscov2
16 de marzo	16 de marzo	FECHAS	16 de marzo
vasculitis	vasculitis	ENFERMEDAD	vasculitis
ictus	ictus	ENFERMEDAD	ictus
urticaria secundaria de origen indeterminado	urticaria secundaria de origen indeterminado	ENFERMEDAD	urticaria secundaria de origen indeterminado
tratamiento con integrilin	tratamiento con integrilin	PROCEDIMIENTO	tratamiento con integrilin
fibrinogeno (proteinas)	fibrinogeno	PROTEINAS	fibrinogeno
exploracion microscopica	exploracion microscopica	PROCEDIMIENTO	exploracion microscopica
IET	IET	PROCEDIMIENTO	IET
sitagliptina	sitagliptina	FARMACO	sitagliptina
59 anos	59 anos	EDAD-SUJETO-ASISTENCIA	59 anos
administracion de esteroides	administracion de esteroides	PROCEDIMIENTO	administracion de esteroides
alcohol fenetilico	alcohol fenetilico	FARMACO	alcohol fenetilico
rinoceronte	rinoceronte	SPECIES	rinoceronte
irritabilidad	irritabilidad	SINTOMA	irritabilidad
quimioterapia	quimioterapia	PROCEDIMIENTO	quimioterapia
Sao paulo	Sao paulo	TERRITORIO	Sao paulo
CD8	CD8	PROTEINAS	CD8
dolor toracico pleural	dolor toracico pleural	SINTOMA	dolor toracico pleural
escalofrios	escalofrios	SINTOMA	escalofrios
oxido nitrico	oxido nitrico	ENTIDAD-OBSERVABLE	oxido nitrico
deficiencias de memoria	deficiencias de memoria	SINTOMA	deficiencias de memoria
RMN cerebral	RMN cerebral	PROCEDIMIENTO	RMN cerebral
aneurisma	aneurisma	ENFERMEDAD	aneurisma
taponamiento del circuito de dialisis	taponamiento del circuito de dialisis	PROCEDIMIENTO	taponamiento del circuito de dialisis
extubacion	extubacion	PROCEDIMIENTO	extubacion
pO2	pO2	ENTIDAD-OBSERVABLE	pO2
taquicardia fetal	taquicardia fetal	ENFERMEDAD	taquicardia fetal
trombocitopenia (sintoma)	trombocitopenia	SINTOMA	trombocitopenia
vomitos	vomitos	SINTOMA	vomitos
